club_id,season,name,last_position,own_goals_1,own_position_1,hosting_1,is_win_1,home_club_formation_1,aggregate_1,opponent_goals_1,opponent_position_1,away_club_formation_1,own_goals_2,own_position_2,hosting_2,is_win_2,home_club_formation_2,aggregate_2,opponent_goals_2,opponent_position_2,away_club_formation_2,own_goals_3,own_position_3,hosting_3,is_win_3,home_club_formation_3,aggregate_3,opponent_goals_3,opponent_position_3,away_club_formation_3,own_goals_4,own_position_4,hosting_4,is_win_4,home_club_formation_4,aggregate_4,opponent_goals_4,opponent_position_4,away_club_formation_4,own_goals_5,own_position_5,hosting_5,is_win_5,home_club_formation_5,aggregate_5,opponent_goals_5,opponent_position_5,away_club_formation_5,own_goals_6,own_position_6,hosting_6,is_win_6,home_club_formation_6,aggregate_6,opponent_goals_6,opponent_position_6,away_club_formation_6,own_goals_7,own_position_7,hosting_7,is_win_7,home_club_formation_7,aggregate_7,opponent_goals_7,opponent_position_7,away_club_formation_7,own_goals_8,own_position_8,hosting_8,is_win_8,home_club_formation_8,aggregate_8,opponent_goals_8,opponent_position_8,away_club_formation_8,own_goals_9,own_position_9,hosting_9,is_win_9,home_club_formation_9,aggregate_9,opponent_goals_9,opponent_position_9,away_club_formation_9,own_goals_10,own_position_10,hosting_10,is_win_10,home_club_formation_10,aggregate_10,opponent_goals_10,opponent_position_10,away_club_formation_10,total_points_1,total_points_2,total_points_3,total_points_4,total_points_5,total_points_6,total_points_7,total_points_8,total_points_9,total_points_10,gols_pro,gols_sofridos,saldo_gols
180.0,2012,Southampton Football Club,14.0,2.0,13.0,0,0,0.0,23,3.0,5.0,0.0,0.0,19.0,1,0,0.0,7,2.0,9.0,0.0,2.0,20.0,1,0,0.0,23,3.0,5.0,0.0,1.0,20.0,0,0,0.0,20,6.0,3.0,0.0,4.0,16.0,1,1,0.0,18,1.0,14.0,0.0,1.0,17.0,0,0,0.0,17,3.0,2.0,0.0,2.0,17.0,1,2,0.0,2,2.0,9.0,0.0,1.0,18.0,0,0,0.0,18,4.0,6.0,0.0,1.0,19.0,1,0,0.0,16,2.0,4.0,0.0,0.0,20.0,0,0,0.0,7,2.0,5.0,0.0,0.0,0.0,0.0,0.0,3.0,3.0,4.0,4.0,4.0,4.0,14.0,28.0,-14.0
512.0,2012,Stoke City,13.0,1.0,9.0,0,2,0.0,1,1.0,10.0,0.0,0.0,12.0,1,2,0.0,0,0.0,13.0,0.0,2.0,13.0,0,2,0.0,2,2.0,10.0,0.0,1.0,13.0,1,2,0.0,1,1.0,4.0,0.0,0.0,13.0,0,0,0.0,6,1.0,1.0,0.0,2.0,13.0,1,1,0.0,7,0.0,12.0,0.0,0.0,13.0,0,2,0.0,0,0.0,14.0,0.0,2.0,14.0,0,0,0.0,24,4.0,2.0,0.0,0.0,14.0,1,2,0.0,0,0.0,11.0,0.0,0.0,16.0,0,0,0.0,6,1.0,15.0,0.0,1.0,2.0,3.0,4.0,4.0,7.0,8.0,8.0,9.0,9.0,8.0,10.0,-2.0
931.0,2012,Fulham Football Club,12.0,5.0,1.0,1,1,0.0,10,0.0,20.0,0.0,2.0,7.0,0,0,0.0,23,3.0,8.0,0.0,0.0,12.0,0,0,0.0,8,3.0,7.0,0.0,3.0,9.0,1,1,0.0,8,0.0,6.0,0.0,2.0,6.0,0,1,0.0,16,1.0,15.0,0.0,1.0,10.0,1,0,0.0,16,2.0,4.0,0.0,2.0,9.0,0,2,0.0,2,2.0,17.0,0.0,1.0,8.0,1,1,0.0,6,0.0,17.0,0.0,3.0,7.0,0,2,0.0,3,3.0,18.0,0.0,2.0,8.0,1,2,0.0,2,2.0,4.0,0.0,3.0,3.0,3.0,6.0,9.0,9.0,10.0,13.0,14.0,15.0,21.0,16.0,5.0
405.0,2012,Aston Villa Football Club,15.0,0.0,15.0,0,0,0.0,6,1.0,8.0,0.0,1.0,20.0,1,0,0.0,17,3.0,3.0,0.0,1.0,16.0,0,2,0.0,1,1.0,11.0,0.0,2.0,14.0,1,1,0.0,7,0.0,5.0,0.0,1.0,14.0,0,0,0.0,18,4.0,16.0,0.0,1.0,15.0,1,2,0.0,1,1.0,6.0,0.0,0.0,16.0,0,0,0.0,7,2.0,5.0,0.0,0.0,17.0,0,0,0.0,6,1.0,8.0,0.0,1.0,17.0,1,2,0.0,1,1.0,16.0,0.0,1.0,17.0,0,1,0.0,6,0.0,12.0,0.0,0.0,0.0,1.0,4.0,4.0,5.0,5.0,5.0,6.0,9.0,8.0,14.0,-6.0
379.0,2012,West Ham United Football Club,10.0,1.0,8.0,1,1,0.0,6,0.0,15.0,0.0,0.0,11.0,0,0,0.0,8,3.0,1.0,0.0,3.0,7.0,1,1,0.0,8,0.0,12.0,0.0,0.0,8.0,0,2,0.0,0,0.0,16.0,0.0,1.0,9.0,1,2,0.0,1,1.0,12.0,0.0,2.0,7.0,0,1,0.0,16,1.0,20.0,0.0,1.0,8.0,1,0,0.0,17,3.0,7.0,0.0,4.0,6.0,1,1,0.0,18,1.0,18.0,0.0,1.0,8.0,0,0,0.0,16,2.0,15.0,0.0,0.0,9.0,1,2,0.0,0,0.0,3.0,0.0,3.0,3.0,6.0,7.0,8.0,11.0,11.0,14.0,14.0,15.0,13.0,11.0,2.0
984.0,2012,West Bromwich Albion,8.0,3.0,3.0,1,1,0.0,8,0.0,18.0,0.0,1.0,4.0,0,2,0.0,1,1.0,14.0,0.0,2.0,3.0,1,1,0.0,7,0.0,6.0,0.0,0.0,6.0,0,0,0.0,8,3.0,9.0,0.0,1.0,4.0,1,1,0.0,6,0.0,20.0,0.0,1.0,6.0,0,2,0.0,1,1.0,15.0,0.0,3.0,6.0,1,1,0.0,23,2.0,20.0,0.0,1.0,7.0,1,0,0.0,16,2.0,3.0,0.0,1.0,9.0,0,0,0.0,16,2.0,10.0,0.0,2.0,5.0,1,1,0.0,7,0.0,20.0,0.0,3.0,4.0,7.0,7.0,10.0,11.0,14.0,14.0,14.0,17.0,15.0,11.0,4.0
289.0,2012,Sunderland AFC,17.0,0.0,12.0,0,2,0.0,0,0.0,11.0,0.0,3.0,5.0,1,1,0.0,8,0.0,16.0,0.0,2.0,8.0,0,2,0.0,2,2.0,2.0,0.0,1.0,10.0,1,2,0.0,1,1.0,17.0,0.0,1.0,12.0,0,2,0.0,1,1.0,9.0,0.0,1.0,8.0,1,1,0.0,6,0.0,16.0,0.0,0.0,10.0,0,0,0.0,8,3.0,3.0,0.0,1.0,11.0,1,2,0.0,1,1.0,12.0,0.0,0.0,11.0,0,2,0.0,0,0.0,14.0,0.0,0.0,12.0,1,0,0.0,6,1.0,17.0,0.0,1.0,4.0,5.0,6.0,7.0,10.0,10.0,11.0,12.0,12.0,9.0,9.0,0.0
631.0,2012,Chelsea Football Club,3.0,2.0,4.0,0,1,0.0,7,0.0,17.0,0.0,2.0,2.0,1,1,0.0,7,0.0,10.0,0.0,4.0,1.0,1,1,0.0,24,2.0,17.0,0.0,0.0,1.0,0,2,0.0,0,0.0,18.0,0.0,1.0,1.0,1,1,0.0,6,0.0,13.0,0.0,2.0,1.0,0,1,0.0,16,1.0,9.0,0.0,4.0,1.0,1,1,0.0,18,1.0,19.0,0.0,4.0,1.0,0,1,0.0,24,2.0,5.0,0.0,2.0,1.0,1,0,0.0,23,3.0,2.0,0.0,1.0,2.0,0,2,0.0,1,1.0,11.0,0.0,3.0,6.0,9.0,10.0,13.0,16.0,19.0,22.0,22.0,23.0,22.0,10.0,12.0
1032.0,2012,Reading FC,19.0,1.0,10.0,1,2,0.0,1,1.0,9.0,0.0,0.0,16.0,0,0,0.0,8,3.0,5.0,0.0,2.0,17.0,0,0,0.0,24,4.0,1.0,0.0,1.0,19.0,1,0,0.0,17,3.0,11.0,0.0,0.0,20.0,0,0,0.0,6,1.0,4.0,0.0,2.0,19.0,1,2,0.0,2,2.0,11.0,0.0,2.0,18.0,0,2,0.0,2,2.0,12.0,0.0,0.0,19.0,0,0,0.0,6,1.0,13.0,0.0,3.0,18.0,1,2,0.0,3,3.0,7.0,0.0,1.0,18.0,0,2,0.0,1,1.0,19.0,0.0,1.0,1.0,1.0,1.0,1.0,2.0,3.0,3.0,4.0,5.0,12.0,21.0,-9.0
1123.0,2012,Norwich City,11.0,0.0,20.0,0,0,0.0,10,5.0,1.0,0.0,1.0,18.0,1,2,0.0,1,1.0,17.0,0.0,1.0,15.0,0,2,0.0,1,1.0,14.0,0.0,0.0,16.0,1,2,0.0,0,0.0,8.0,0.0,0.0,17.0,0,0,0.0,6,1.0,10.0,0.0,2.0,18.0,1,0,0.0,25,5.0,14.0,0.0,1.0,19.0,0,0,0.0,18,4.0,1.0,0.0,1.0,15.0,1,1,0.0,6,0.0,9.0,0.0,1.0,16.0,0,2,0.0,1,1.0,17.0,0.0,1.0,15.0,1,1,0.0,6,0.0,16.0,0.0,0.0,1.0,2.0,3.0,3.0,3.0,3.0,6.0,7.0,10.0,8.0,18.0,-10.0
11.0,2012,Arsenal Football Club,4.0,0.0,11.0,1,2,0.0,0,0.0,12.0,0.0,0.0,13.0,0,2,0.0,0,0.0,12.0,0.0,2.0,9.0,0,1,0.0,7,0.0,18.0,0.0,6.0,3.0,1,1,0.0,20,1.0,20.0,0.0,1.0,5.0,0,2,0.0,1,1.0,7.0,0.0,1.0,9.0,1,0,0.0,16,2.0,1.0,0.0,3.0,7.0,0,1,0.0,17,1.0,8.0,0.0,0.0,9.0,0,0,0.0,6,1.0,15.0,0.0,1.0,6.0,1,1,0.0,6,0.0,20.0,0.0,1.0,7.0,0,0,0.0,16,2.0,1.0,0.0,1.0,2.0,5.0,8.0,9.0,9.0,12.0,12.0,15.0,15.0,15.0,8.0,7.0
281.0,2012,Manchester City Football Club,2.0,3.0,5.0,1,1,0.0,23,2.0,13.0,0.0,2.0,6.0,0,2,0.0,2,2.0,15.0,0.0,3.0,4.0,1,1,0.0,17,1.0,19.0,0.0,1.0,4.0,0,2,0.0,1,1.0,13.0,0.0,1.0,7.0,1,2,0.0,1,1.0,5.0,0.0,2.0,4.0,0,1,0.0,16,1.0,10.0,0.0,3.0,3.0,1,1,0.0,8,0.0,10.0,0.0,2.0,3.0,0,1,0.0,16,1.0,7.0,0.0,1.0,3.0,1,1,0.0,6,0.0,12.0,0.0,0.0,3.0,0,2,0.0,0,0.0,9.0,0.0,3.0,4.0,7.0,8.0,9.0,12.0,15.0,18.0,21.0,22.0,18.0,9.0,9.0
762.0,2012,Newcastle United Football Club,16.0,2.0,6.0,1,1,0.0,16,1.0,14.0,0.0,0.0,10.0,0,0,0.0,7,2.0,2.0,0.0,1.0,11.0,1,2,0.0,1,1.0,16.0,0.0,2.0,12.0,0,2,0.0,2,2.0,7.0,0.0,1.0,10.0,1,1,0.0,6,0.0,17.0,0.0,2.0,11.0,0,2,0.0,2,2.0,19.0,0.0,0.0,11.0,1,0,0.0,8,3.0,2.0,0.0,1.0,12.0,0,2,0.0,1,1.0,11.0,0.0,2.0,10.0,1,1,0.0,16,1.0,9.0,0.0,1.0,10.0,0,2,0.0,1,1.0,13.0,0.0,3.0,3.0,4.0,5.0,8.0,9.0,9.0,10.0,13.0,14.0,12.0,14.0,-2.0
31.0,2012,Liverpool Football Club,7.0,0.0,18.0,0,0,0.0,8,3.0,3.0,0.0,2.0,15.0,1,2,0.0,2,2.0,6.0,0.0,0.0,18.0,1,0,0.0,7,2.0,9.0,0.0,1.0,17.0,0,2,0.0,1,1.0,10.0,0.0,1.0,18.0,1,0,0.0,16,2.0,2.0,0.0,5.0,14.0,0,1,0.0,25,2.0,18.0,0.0,0.0,14.0,1,2,0.0,0,0.0,13.0,0.0,1.0,13.0,1,1,0.0,6,0.0,19.0,0.0,2.0,13.0,0,2,0.0,2,2.0,5.0,0.0,1.0,13.0,1,2,0.0,1,1.0,10.0,0.0,0.0,1.0,1.0,2.0,2.0,5.0,6.0,9.0,10.0,11.0,13.0,15.0,-2.0
29.0,2012,Everton Football Club,6.0,1.0,7.0,1,1,0.0,6,0.0,16.0,0.0,3.0,3.0,0,1,0.0,17,1.0,20.0,0.0,0.0,6.0,0,0,0.0,7,2.0,3.0,0.0,2.0,7.0,1,2,0.0,2,2.0,12.0,0.0,3.0,3.0,0,1,0.0,8,0.0,11.0,0.0,3.0,2.0,1,1,0.0,17,1.0,17.0,0.0,2.0,4.0,0,2,0.0,2,2.0,15.0,0.0,1.0,4.0,0,2,0.0,1,1.0,20.0,0.0,2.0,5.0,1,2,0.0,2,2.0,13.0,0.0,2.0,4.0,0,2,0.0,2,2.0,8.0,0.0,3.0,6.0,6.0,7.0,10.0,13.0,14.0,15.0,16.0,17.0,19.0,13.0,6.0
1039.0,2012,Queens Park Rangers,20.0,0.0,19.0,1,0,0.0,10,5.0,2.0,0.0,1.0,17.0,0,2,0.0,1,1.0,18.0,0.0,1.0,19.0,0,0,0.0,17,3.0,4.0,0.0,0.0,18.0,1,2,0.0,0,0.0,1.0,0.0,1.0,19.0,0,0,0.0,16,2.0,8.0,0.0,1.0,20.0,1,0,0.0,16,2.0,7.0,0.0,2.0,20.0,0,0,0.0,23,3.0,6.0,0.0,1.0,20.0,1,2,0.0,1,1.0,4.0,0.0,0.0,20.0,0,0,0.0,6,1.0,6.0,0.0,1.0,19.0,1,2,0.0,1,1.0,18.0,0.0,0.0,1.0,1.0,2.0,2.0,2.0,2.0,3.0,3.0,4.0,8.0,19.0,-11.0
2288.0,2012,Swansea City,9.0,5.0,2.0,0,1,0.0,10,0.0,19.0,0.0,3.0,1.0,1,1,0.0,8,0.0,11.0,0.0,2.0,2.0,1,2,0.0,2,2.0,8.0,0.0,0.0,5.0,0,0,0.0,7,2.0,14.0,0.0,0.0,11.0,1,0,0.0,8,3.0,3.0,0.0,0.0,12.0,0,0,0.0,7,2.0,13.0,0.0,2.0,12.0,1,2,0.0,2,2.0,18.0,0.0,2.0,10.0,1,1,0.0,16,1.0,16.0,0.0,0.0,12.0,0,0,0.0,6,1.0,3.0,0.0,1.0,11.0,1,2,0.0,1,1.0,2.0,0.0,3.0,6.0,7.0,7.0,7.0,7.0,8.0,11.0,11.0,12.0,15.0,14.0,1.0
985.0,2012,Manchester United Football Club,1.0,0.0,16.0,0,0,0.0,6,1.0,7.0,0.0,3.0,8.0,1,1,0.0,23,2.0,7.0,0.0,3.0,5.0,0,1,0.0,23,2.0,20.0,0.0,4.0,2.0,1,1,0.0,9,0.0,15.0,0.0,2.0,2.0,0,1,0.0,16,1.0,18.0,0.0,2.0,3.0,1,0,0.0,23,3.0,5.0,0.0,3.0,2.0,0,1,0.0,8,0.0,11.0,0.0,4.0,2.0,1,1,0.0,24,2.0,14.0,0.0,3.0,2.0,0,1,0.0,23,2.0,1.0,0.0,2.0,1.0,1,1,0.0,16,1.0,7.0,0.0,0.0,3.0,6.0,9.0,12.0,12.0,15.0,18.0,21.0,24.0,26.0,14.0,12.0
1071.0,2012,Wigan Athletic,18.0,0.0,17.0,1,0,0.0,7,2.0,4.0,0.0,2.0,9.0,0,1,0.0,7,0.0,19.0,0.0,2.0,10.0,1,2,0.0,2,2.0,13.0,0.0,0.0,15.0,0,0,0.0,9,4.0,2.0,0.0,1.0,15.0,1,0,0.0,16,2.0,6.0,0.0,0.0,16.0,0,0,0.0,6,1.0,8.0,0.0,2.0,15.0,1,2,0.0,2,2.0,4.0,0.0,1.0,16.0,0,0,0.0,16,2.0,10.0,0.0,2.0,15.0,1,1,0.0,16,1.0,8.0,0.0,1.0,14.0,0,1,0.0,6,0.0,6.0,0.0,0.0,3.0,4.0,4.0,4.0,4.0,5.0,5.0,8.0,11.0,11.0,16.0,-5.0
148.0,2012,Tottenham Hotspur Football Club,5.0,1.0,14.0,0,0,0.0,16,2.0,6.0,0.0,1.0,14.0,1,2,0.0,1,1.0,4.0,0.0,1.0,14.0,1,2,0.0,1,1.0,15.0,0.0,3.0,11.0,0,1,0.0,17,1.0,19.0,0.0,2.0,8.0,1,1,0.0,16,1.0,19.0,0.0,3.0,5.0,0,1,0.0,23,2.0,3.0,0.0,2.0,5.0,1,1,0.0,7,0.0,16.0,0.0,2.0,5.0,1,0,0.0,24,4.0,1.0,0.0,2.0,4.0,0,1,0.0,16,1.0,19.0,0.0,0.0,6.0,1,0,0.0,6,1.0,14.0,0.0,0.0,1.0,2.0,5.0,8.0,11.0,14.0,14.0,17.0,17.0,17.0,14.0,3.0
512.0,2013,Stoke City,9.0,0.0,13.0,0,0,6.0,6,1.0,6.0,1.0,2.0,10.0,1,1,7.0,16,1.0,19.0,7.0,1.0,5.0,0,1,1.0,6,0.0,8.0,1.0,0.0,7.0,1,2,1.0,0,0.0,4.0,3.0,1.0,10.0,0,0,1.0,17,3.0,1.0,1.0,0.0,14.0,1,0,1.0,6,1.0,15.0,7.0,0.0,16.0,0,0,1.0,6,1.0,17.0,1.0,0.0,16.0,1,2,1.0,0,0.0,12.0,1.0,2.0,17.0,0,0,1.0,23,3.0,8.0,1.0,1.0,17.0,1,2,1.0,1,1.0,6.0,1.0,0.0,3.0,6.0,7.0,7.0,7.0,7.0,8.0,8.0,9.0,7.0,11.0,-4.0
984.0,2013,West Bromwich Albion,17.0,0.0,15.0,1,0,3.0,6,1.0,8.0,13.0,0.0,17.0,0,2,3.0,0,0.0,14.0,1.0,0.0,20.0,1,0,3.0,7,2.0,16.0,4.0,1.0,19.0,0,2,3.0,1,1.0,14.0,1.0,3.0,15.0,1,1,1.0,8,0.0,20.0,13.0,2.0,10.0,0,1,1.0,16,1.0,12.0,1.0,1.0,12.0,1,2,1.0,1,1.0,1.0,1.0,0.0,12.0,0,2,1.0,0,0.0,16.0,1.0,1.0,12.0,0,0,3.0,18,4.0,3.0,17.0,2.0,11.0,1,1,3.0,7,0.0,20.0,1.0,0.0,1.0,1.0,2.0,5.0,8.0,9.0,10.0,10.0,13.0,10.0,10.0,0.0
289.0,2013,Sunderland AFC,14.0,0.0,12.0,1,0,1.0,6,1.0,9.0,12.0,1.0,16.0,0,2,1.0,1,1.0,6.0,1.0,1.0,19.0,0,0,1.0,17,3.0,14.0,1.0,1.0,20.0,1,0,3.0,17,3.0,2.0,1.0,0.0,20.0,0,0,13.0,8,3.0,15.0,1.0,1.0,20.0,1,0,7.0,17,3.0,2.0,18.0,1.0,20.0,1,0,7.0,16,2.0,9.0,1.0,0.0,20.0,0,0,1.0,9,4.0,11.0,1.0,2.0,19.0,1,1,3.0,16,1.0,11.0,7.0,0.0,19.0,0,0,3.0,6,1.0,10.0,6.0,0.0,1.0,1.0,1.0,1.0,1.0,1.0,1.0,4.0,4.0,7.0,22.0,-15.0
379.0,2013,West Ham United Football Club,13.0,2.0,4.0,1,1,1.0,7,0.0,17.0,1.0,0.0,4.0,0,2,1.0,0,0.0,18.0,3.0,0.0,8.0,1,0,1.0,6,1.0,5.0,1.0,0.0,10.0,0,2,1.0,0,0.0,11.0,3.0,2.0,14.0,1,0,1.0,23,3.0,6.0,1.0,0.0,17.0,0,0,1.0,6,1.0,8.0,3.0,3.0,13.0,0,1,7.0,8,0.0,6.0,1.0,1.0,15.0,1,0,7.0,17,3.0,4.0,3.0,0.0,15.0,0,2,7.0,0,0.0,9.0,1.0,0.0,15.0,1,2,1.0,0,0.0,14.0,9.0,3.0,4.0,4.0,5.0,5.0,5.0,8.0,8.0,9.0,10.0,8.0,8.0,0.0
281.0,2013,Manchester City Football Club,1.0,4.0,1.0,1,1,3.0,9,0.0,20.0,3.0,2.0,7.0,0,0,3.0,23,3.0,11.0,1.0,2.0,3.0,1,1,12.0,7,0.0,18.0,12.0,0.0,4.0,0,2,3.0,0,0.0,7.0,1.0,4.0,3.0,1,1,3.0,18,1.0,8.0,3.0,2.0,7.0,0,0,3.0,23,3.0,9.0,9.0,3.0,5.0,1,1,1.0,17,1.0,7.0,1.0,3.0,4.0,0,1,3.0,17,1.0,15.0,7.0,1.0,7.0,0,0,1.0,16,2.0,2.0,1.0,7.0,5.0,1,1,3.0,12,0.0,18.0,12.0,3.0,3.0,6.0,7.0,10.0,10.0,13.0,16.0,16.0,19.0,28.0,11.0,17.0
1123.0,2013,Norwich City,18.0,2.0,11.0,1,2,1.0,2,2.0,10.0,1.0,0.0,15.0,0,0,1.0,6,1.0,13.0,1.0,1.0,9.0,1,1,3.0,6,0.0,10.0,3.0,0.0,15.0,0,0,1.0,7,2.0,3.0,1.0,0.0,17.0,1,0,1.0,6,1.0,13.0,5.0,1.0,15.0,0,1,7.0,6,0.0,14.0,1.0,1.0,18.0,1,0,7.0,17,3.0,3.0,1.0,1.0,18.0,0,0,7.0,18,4.0,1.0,1.0,0.0,18.0,1,2,7.0,0,0.0,16.0,7.0,0.0,18.0,0,0,12.0,12,7.0,5.0,3.0,1.0,1.0,4.0,4.0,4.0,7.0,7.0,7.0,8.0,8.0,6.0,20.0,-14.0
762.0,2013,Newcastle United Football Club,10.0,0.0,20.0,0,0,3.0,9,4.0,1.0,3.0,0.0,18.0,1,2,3.0,0,0.0,4.0,1.0,1.0,12.0,1,1,3.0,6,0.0,17.0,3.0,2.0,8.0,0,1,4.0,16,1.0,17.0,5.0,2.0,12.0,1,0,4.0,23,3.0,11.0,3.0,2.0,16.0,0,0,1.0,23,3.0,4.0,1.0,2.0,11.0,0,1,7.0,16,1.0,14.0,1.0,2.0,10.0,1,2,7.0,2,2.0,3.0,17.0,1.0,11.0,0,0,7.0,16,2.0,19.0,3.0,2.0,9.0,1,1,3.0,7,0.0,2.0,1.0,0.0,1.0,4.0,7.0,7.0,7.0,10.0,11.0,11.0,14.0,14.0,16.0,-2.0
180.0,2013,Southampton Football Club,8.0,1.0,8.0,0,1,13.0,6,0.0,15.0,3.0,1.0,6.0,1,2,1.0,1,1.0,16.0,1.0,0.0,10.0,0,0,3.0,6,1.0,9.0,3.0,0.0,11.0,1,2,3.0,0,0.0,10.0,1.0,1.0,7.0,0,1,1.0,6,0.0,5.0,1.0,2.0,6.0,1,1,3.0,7,0.0,19.0,5.0,2.0,4.0,1,1,1.0,7,0.0,15.0,1.0,1.0,6.0,0,2,1.0,1,1.0,8.0,1.0,2.0,5.0,1,1,1.0,7,0.0,14.0,1.0,1.0,6.0,0,2,1.0,1,1.0,17.0,1.0,3.0,4.0,4.0,5.0,8.0,11.0,14.0,15.0,18.0,19.0,11.0,4.0,7.0
11.0,2013,Arsenal Football Club,4.0,1.0,16.0,1,0,1.0,17,3.0,3.0,5.0,3.0,9.0,0,1,1.0,17,1.0,12.0,1.0,1.0,4.0,1,1,1.0,6,0.0,6.0,4.0,3.0,2.0,0,1,1.0,17,1.0,20.0,3.0,3.0,1.0,1,1,1.0,17,1.0,10.0,1.0,2.0,1.0,0,1,1.0,16,1.0,13.0,4.0,1.0,1.0,0,2,1.0,1,1.0,12.0,1.0,4.0,1.0,1,1,1.0,18,1.0,18.0,7.0,2.0,1.0,0,1,1.0,7,0.0,20.0,1.0,2.0,1.0,1,1,1.0,7,0.0,3.0,17.0,0.0,3.0,6.0,9.0,12.0,15.0,16.0,19.0,22.0,25.0,22.0,9.0,13.0
405.0,2013,Aston Villa Football Club,15.0,3.0,3.0,0,1,5.0,17,1.0,16.0,1.0,0.0,8.0,1,0,1.0,6,1.0,1.0,1.0,1.0,13.0,0,0,5.0,16,2.0,2.0,1.0,1.0,17.0,1,0,5.0,16,2.0,8.0,4.0,1.0,13.0,0,1,5.0,6,0.0,17.0,1.0,3.0,9.0,1,1,9.0,23,2.0,7.0,3.0,0.0,10.0,0,2,5.0,0,0.0,8.0,3.0,0.0,13.0,1,0,5.0,7,2.0,5.0,1.0,0.0,13.0,1,0,1.0,7,2.0,6.0,1.0,0.0,14.0,0,2,9.0,0,0.0,15.0,1.0,3.0,3.0,3.0,3.0,6.0,9.0,10.0,10.0,10.0,11.0,9.0,12.0,-3.0
873.0,2013,Crystal Palace Football Club,11.0,0.0,14.0,1,0,1.0,6,1.0,7.0,4.0,1.0,19.0,0,0,7.0,16,2.0,10.0,7.0,3.0,14.0,1,1,1.0,17,1.0,19.0,1.0,0.0,18.0,0,0,1.0,7,2.0,5.0,13.0,0.0,19.0,1,0,1.0,7,2.0,9.0,4.0,0.0,19.0,0,0,5.0,7,2.0,6.0,3.0,1.0,19.0,0,0,5.0,17,3.0,2.0,18.0,1.0,19.0,1,0,5.0,18,4.0,14.0,12.0,0.0,20.0,1,0,1.0,7,2.0,1.0,1.0,0.0,20.0,0,0,1.0,7,2.0,11.0,3.0,0.0,0.0,3.0,3.0,3.0,3.0,3.0,3.0,3.0,3.0,6.0,21.0,-15.0
29.0,2013,Everton Football Club,5.0,2.0,10.0,0,2,1.0,2,2.0,11.0,1.0,0.0,14.0,1,2,1.0,0,0.0,17.0,3.0,0.0,15.0,0,2,1.0,0,0.0,11.0,1.0,1.0,9.0,1,1,1.0,6,0.0,6.0,1.0,3.0,6.0,0,1,1.0,23,2.0,14.0,1.0,3.0,4.0,1,1,1.0,23,2.0,16.0,1.0,1.0,7.0,0,0,1.0,17,3.0,5.0,1.0,2.0,7.0,1,1,1.0,16,1.0,9.0,3.0,2.0,6.0,0,1,1.0,7,0.0,13.0,1.0,0.0,7.0,1,2,1.0,0,0.0,4.0,7.0,1.0,2.0,3.0,6.0,9.0,12.0,12.0,15.0,18.0,19.0,14.0,10.0,4.0
148.0,2013,Tottenham Hotspur Football Club,6.0,1.0,7.0,0,1,4.0,6,0.0,14.0,1.0,1.0,2.0,1,1,4.0,6,0.0,20.0,4.0,0.0,6.0,0,0,4.0,6,1.0,4.0,1.0,2.0,3.0,1,1,1.0,7,0.0,15.0,1.0,1.0,2.0,0,1,1.0,6,0.0,16.0,1.0,1.0,3.0,1,2,1.0,1,1.0,5.0,2.0,0.0,6.0,1,0,1.0,8,3.0,13.0,7.0,2.0,5.0,0,1,1.0,7,0.0,13.0,5.0,1.0,4.0,1,1,7.0,6,0.0,10.0,11.0,0.0,4.0,0,2,7.0,0,0.0,7.0,1.0,3.0,6.0,6.0,9.0,12.0,13.0,13.0,16.0,19.0,20.0,9.0,5.0,4.0
2288.0,2013,Swansea City,12.0,1.0,19.0,1,0,4.0,18,4.0,2.0,13.0,0.0,20.0,0,0,4.0,6,1.0,2.0,4.0,2.0,16.0,0,1,4.0,7,0.0,20.0,3.0,2.0,13.0,1,2,4.0,2,2.0,1.0,1.0,2.0,9.0,0,1,4.0,7,0.0,19.0,1.0,1.0,13.0,1,0,4.0,16,2.0,1.0,1.0,0.0,15.0,0,0,1.0,7,2.0,4.0,1.0,4.0,11.0,1,1,1.0,9,0.0,20.0,1.0,0.0,9.0,1,2,1.0,0,0.0,15.0,7.0,0.0,13.0,0,0,1.0,6,1.0,12.0,7.0,0.0,0.0,3.0,4.0,7.0,7.0,7.0,10.0,11.0,11.0,12.0,12.0,0.0
985.0,2013,Manchester United Football Club,7.0,4.0,2.0,0,1,13.0,18,1.0,19.0,4.0,0.0,3.0,1,2,1.0,0,0.0,5.0,1.0,0.0,7.0,0,0,13.0,6,1.0,1.0,3.0,2.0,5.0,1,1,13.0,7,0.0,18.0,1.0,1.0,8.0,0,0,3.0,18,4.0,3.0,3.0,1.0,12.0,1,0,1.0,16,2.0,10.0,1.0,2.0,9.0,0,1,1.0,16,1.0,20.0,7.0,1.0,8.0,1,2,1.0,1,1.0,6.0,1.0,3.0,8.0,1,1,1.0,23,2.0,17.0,1.0,3.0,8.0,0,1,1.0,17,1.0,16.0,1.0,3.0,4.0,4.0,7.0,7.0,7.0,10.0,11.0,14.0,17.0,17.0,13.0,4.0
631.0,2013,Chelsea Football Club,3.0,2.0,5.0,1,1,1.0,7,0.0,18.0,5.0,0.0,5.0,0,2,1.0,0,0.0,3.0,1.0,2.0,2.0,1,1,1.0,16,1.0,13.0,5.0,0.0,6.0,0,0,1.0,6,1.0,9.0,1.0,2.0,4.0,1,1,1.0,7,0.0,18.0,1.0,1.0,5.0,0,2,2.0,1,1.0,3.0,1.0,3.0,3.0,0,1,1.0,17,1.0,18.0,7.0,4.0,2.0,1,1,1.0,18,1.0,17.0,7.0,2.0,2.0,1,1,1.0,16,1.0,7.0,1.0,0.0,2.0,0,0,1.0,7,2.0,9.0,3.0,3.0,4.0,7.0,7.0,10.0,11.0,14.0,17.0,20.0,20.0,16.0,8.0,8.0
3008.0,2013,Hull City,16.0,0.0,18.0,0,0,5.0,7,2.0,5.0,1.0,1.0,13.0,1,1,1.0,6,0.0,15.0,1.0,0.0,18.0,0,0,12.0,7,2.0,3.0,12.0,1.0,16.0,1,2,3.0,1,1.0,12.0,7.0,3.0,11.0,0,1,3.0,23,2.0,12.0,4.0,1.0,8.0,1,1,3.0,6,0.0,17.0,1.0,0.0,8.0,1,2,3.0,0,0.0,10.0,5.0,1.0,9.0,0,0,3.0,16,2.0,7.0,1.0,0.0,10.0,0,0,11.0,6,1.0,4.0,7.0,1.0,10.0,1,1,6.0,6,0.0,19.0,3.0,0.0,3.0,3.0,4.0,7.0,10.0,11.0,11.0,11.0,14.0,8.0,10.0,-2.0
31.0,2013,Liverpool Football Club,2.0,1.0,6.0,1,1,1.0,6,0.0,13.0,6.0,1.0,1.0,0,1,1.0,6,0.0,8.0,1.0,1.0,1.0,1,1,3.0,6,0.0,7.0,13.0,2.0,1.0,0,2,1.0,2,2.0,13.0,4.0,0.0,5.0,1,0,1.0,6,1.0,7.0,1.0,3.0,2.0,0,1,18.0,17,1.0,20.0,7.0,3.0,2.0,1,1,18.0,17,1.0,19.0,5.0,2.0,3.0,0,2,17.0,2,2.0,10.0,7.0,4.0,3.0,1,1,17.0,18,1.0,12.0,3.0,0.0,3.0,0,0,17.0,7,2.0,1.0,1.0,3.0,6.0,9.0,10.0,10.0,13.0,16.0,17.0,20.0,20.0,17.0,10.0,7.0
603.0,2013,Cardiff City,20.0,0.0,17.0,0,0,1.0,7,2.0,4.0,1.0,3.0,11.0,1,1,1.0,23,2.0,7.0,3.0,0.0,11.0,1,2,1.0,0,0.0,15.0,1.0,1.0,12.0,0,2,7.0,1,1.0,16.0,3.0,0.0,16.0,1,0,1.0,6,1.0,2.0,1.0,2.0,11.0,0,1,1.0,16,1.0,18.0,3.0,1.0,14.0,1,0,1.0,16,2.0,11.0,7.0,1.0,17.0,0,0,7.0,18,4.0,2.0,1.0,0.0,16.0,0,2,7.0,0,0.0,18.0,7.0,1.0,12.0,1,1,7.0,6,0.0,13.0,1.0,0.0,3.0,4.0,5.0,5.0,8.0,8.0,8.0,9.0,12.0,9.0,13.0,-4.0
931.0,2013,Fulham Football Club,19.0,1.0,9.0,0,1,12.0,6,0.0,12.0,1.0,1.0,12.0,1,0,1.0,17,3.0,9.0,1.0,0.0,17.0,0,0,3.0,6,1.0,12.0,3.0,1.0,14.0,1,2,1.0,1,1.0,19.0,3.0,0.0,18.0,0,0,1.0,7,2.0,4.0,1.0,1.0,18.0,1,0,3.0,16,2.0,11.0,1.0,1.0,17.0,1,1,1.0,6,0.0,16.0,1.0,4.0,14.0,0,1,12.0,18,1.0,19.0,5.0,0.0,14.0,0,0,1.0,7,2.0,5.0,1.0,1.0,16.0,1,0,1.0,17,3.0,8.0,1.0,3.0,3.0,3.0,4.0,4.0,4.0,7.0,10.0,10.0,10.0,10.0,15.0,-5.0
11.0,2014,Arsenal Football Club,3.0,2.0,3.0,1,1,7.0,16,1.0,14.0,1.0,2.0,5.0,0,2,7.0,2,2.0,10.0,1.0,1.0,7.0,0,2,7.0,1,1.0,16.0,13.0,2.0,7.0,1,2,7.0,2,2.0,5.0,1.0,3.0,4.0,0,1,1.0,8,0.0,3.0,7.0,1.0,4.0,1,2,4.0,1,1.0,8.0,1.0,0.0,8.0,0,0,1.0,7,2.0,1.0,1.0,2.0,7.0,1,2,1.0,2,2.0,11.0,9.0,2.0,5.0,0,1,1.0,7,0.0,18.0,7.0,3.0,4.0,1,1,1.0,8,0.0,20.0,13.0,3.0,4.0,5.0,6.0,9.0,10.0,10.0,11.0,14.0,17.0,18.0,11.0,7.0
1039.0,2014,Queens Park Rangers,20.0,0.0,18.0,1,0,17.0,6,1.0,8.0,11.0,0.0,20.0,0,0,9.0,9,4.0,1.0,1.0,1.0,12.0,1,1,7.0,6,0.0,13.0,7.0,0.0,16.0,0,0,7.0,9,4.0,9.0,10.0,2.0,18.0,1,2,13.0,2,2.0,13.0,1.0,1.0,18.0,0,0,12.0,16,2.0,2.0,4.0,0.0,20.0,0,0,12.0,7,2.0,7.0,10.0,2.0,20.0,1,0,3.0,23,3.0,5.0,1.0,2.0,19.0,1,1,3.0,7,0.0,15.0,3.0,1.0,19.0,0,0,12.0,16,2.0,1.0,1.0,0.0,0.0,3.0,3.0,4.0,4.0,4.0,4.0,7.0,7.0,9.0,20.0,-11.0
984.0,2014,West Bromwich Albion,13.0,2.0,11.0,1,2,1.0,2,2.0,10.0,3.0,0.0,12.0,0,2,1.0,0,0.0,14.0,1.0,0.0,18.0,0,0,1.0,8,3.0,2.0,1.0,0.0,19.0,1,0,13.0,7,2.0,11.0,1.0,1.0,16.0,0,1,12.0,6,0.0,9.0,1.0,4.0,10.0,1,1,12.0,9,0.0,20.0,7.0,1.0,14.0,0,0,12.0,16,2.0,9.0,1.0,2.0,14.0,1,2,12.0,2,2.0,6.0,1.0,2.0,13.0,1,2,12.0,2,2.0,16.0,12.0,1.0,11.0,0,1,12.0,6,0.0,18.0,8.0,1.0,2.0,2.0,2.0,5.0,8.0,8.0,9.0,10.0,13.0,13.0,13.0,0.0
31.0,2014,Liverpool Football Club,6.0,2.0,4.0,1,1,1.0,16,1.0,13.0,1.0,1.0,9.0,0,0,7.0,17,3.0,2.0,12.0,3.0,5.0,0,1,8.0,8,0.0,6.0,1.0,0.0,8.0,1,0,1.0,6,1.0,2.0,7.0,1.0,11.0,0,0,8.0,17,3.0,8.0,8.0,1.0,14.0,1,2,1.0,1,1.0,15.0,5.0,2.0,9.0,1,1,1.0,16,1.0,14.0,12.0,3.0,5.0,0,1,1.0,23,2.0,20.0,3.0,0.0,7.0,1,2,5.0,0,0.0,10.0,9.0,0.0,7.0,0,0,5.0,6,1.0,12.0,1.0,3.0,3.0,6.0,6.0,6.0,7.0,10.0,13.0,14.0,14.0,13.0,13.0,0.0
180.0,2014,Southampton Football Club,7.0,1.0,13.0,0,0,1.0,16,2.0,4.0,1.0,0.0,14.0,1,2,1.0,0,0.0,12.0,1.0,3.0,8.0,0,1,1.0,17,1.0,11.0,1.0,4.0,4.0,1,1,5.0,9,0.0,20.0,4.0,1.0,2.0,0,1,5.0,6,0.0,5.0,1.0,2.0,2.0,1,1,4.0,16,1.0,18.0,12.0,0.0,3.0,0,0,5.0,6,1.0,6.0,1.0,8.0,3.0,1,1,5.0,13,0.0,17.0,7.0,1.0,2.0,1,1,4.0,6,0.0,12.0,5.0,1.0,2.0,0,1,5.0,6,0.0,14.0,9.0,0.0,1.0,4.0,7.0,10.0,13.0,13.0,16.0,19.0,22.0,21.0,5.0,16.0
512.0,2014,Stoke City,9.0,0.0,17.0,1,0,1.0,6,1.0,7.0,5.0,1.0,15.0,0,2,1.0,1,1.0,6.0,17.0,1.0,10.0,0,1,3.0,6,0.0,4.0,3.0,0.0,14.0,1,0,1.0,6,1.0,12.0,13.0,2.0,13.0,0,2,1.0,2,2.0,18.0,13.0,1.0,11.0,1,1,5.0,6,0.0,19.0,1.0,1.0,16.0,0,0,1.0,17,3.0,13.0,7.0,2.0,10.0,1,1,5.0,16,1.0,8.0,1.0,0.0,12.0,0,0,5.0,6,1.0,2.0,4.0,2.0,13.0,1,2,1.0,2,2.0,5.0,7.0,0.0,1.0,4.0,4.0,5.0,8.0,8.0,11.0,11.0,12.0,10.0,12.0,-2.0
873.0,2014,Crystal Palace Football Club,10.0,1.0,14.0,0,0,1.0,16,2.0,3.0,7.0,1.0,18.0,1,0,1.0,17,3.0,8.0,1.0,3.0,19.0,0,2,3.0,3,3.0,15.0,1.0,0.0,17.0,1,2,1.0,0,0.0,18.0,13.0,3.0,15.0,0,1,7.0,23,2.0,14.0,1.0,2.0,9.0,1,1,4.0,7,0.0,12.0,5.0,0.0,15.0,0,0,5.0,7,2.0,11.0,9.0,1.0,16.0,1,0,4.0,16,2.0,1.0,1.0,2.0,16.0,0,2,12.0,2,2.0,13.0,12.0,1.0,17.0,1,0,1.0,17,3.0,15.0,7.0,0.0,0.0,1.0,2.0,5.0,8.0,8.0,8.0,9.0,9.0,14.0,19.0,-5.0
3008.0,2014,Hull City,18.0,1.0,8.0,0,1,11.0,6,0.0,18.0,17.0,1.0,6.0,1,2,17.0,1,1.0,15.0,1.0,1.0,9.0,0,0,14.0,16,2.0,3.0,5.0,2.0,10.0,1,2,13.0,2,2.0,13.0,10.0,2.0,10.0,0,2,3.0,2,2.0,20.0,1.0,2.0,16.0,1,0,3.0,24,4.0,3.0,3.0,2.0,11.0,1,1,9.0,7,0.0,15.0,5.0,2.0,11.0,0,2,9.0,2,2.0,7.0,1.0,0.0,10.0,0,2,9.0,0,0.0,7.0,5.0,0.0,14.0,1,0,9.0,6,1.0,2.0,5.0,3.0,4.0,4.0,5.0,6.0,6.0,9.0,10.0,11.0,11.0,13.0,14.0,-1.0
762.0,2014,Newcastle United Football Club,15.0,0.0,20.0,1,0,5.0,7,2.0,2.0,3.0,0.0,17.0,0,2,1.0,0,0.0,7.0,5.0,3.0,15.0,1,2,1.0,3,3.0,19.0,3.0,0.0,20.0,0,0,4.0,9,4.0,4.0,5.0,2.0,20.0,1,2,1.0,2,2.0,10.0,3.0,0.0,19.0,0,0,1.0,6,1.0,11.0,5.0,2.0,18.0,0,2,6.0,2,2.0,5.0,1.0,1.0,18.0,1,1,4.0,6,0.0,15.0,7.0,2.0,14.0,0,1,4.0,16,1.0,11.0,1.0,1.0,12.0,1,1,1.0,6,0.0,7.0,5.0,0.0,1.0,2.0,2.0,3.0,3.0,4.0,7.0,10.0,13.0,11.0,15.0,-4.0
379.0,2014,West Ham United Football Club,12.0,0.0,16.0,1,0,1.0,6,1.0,6.0,1.0,3.0,8.0,0,1,1.0,17,1.0,18.0,1.0,1.0,11.0,1,0,1.0,17,3.0,8.0,1.0,2.0,13.0,0,2,10.0,2,2.0,10.0,13.0,3.0,8.0,1,1,8.0,17,1.0,11.0,8.0,1.0,13.0,0,0,1.0,16,2.0,7.0,10.0,2.0,7.0,1,1,10.0,7,0.0,20.0,12.0,3.0,4.0,0,1,8.0,17,1.0,19.0,12.0,2.0,4.0,1,1,8.0,16,1.0,3.0,3.0,2.0,5.0,0,2,7.0,2,2.0,13.0,1.0,0.0,3.0,3.0,4.0,7.0,7.0,10.0,13.0,16.0,17.0,19.0,14.0,5.0
2288.0,2014,Swansea City,8.0,2.0,5.0,0,1,1.0,16,1.0,15.0,18.0,1.0,4.0,1,1,1.0,6,0.0,19.0,12.0,3.0,2.0,1,1,1.0,8,0.0,18.0,1.0,2.0,3.0,0,0,1.0,24,4.0,1.0,1.0,0.0,5.0,1,0,1.0,6,1.0,2.0,5.0,0.0,5.0,0,2,1.0,0,0.0,17.0,1.0,2.0,5.0,1,2,1.0,2,2.0,18.0,6.0,1.0,8.0,0,0,1.0,16,2.0,10.0,5.0,2.0,6.0,1,1,1.0,7,0.0,17.0,1.0,0.0,6.0,0,2,1.0,0,0.0,9.0,1.0,3.0,6.0,9.0,9.0,9.0,10.0,11.0,11.0,14.0,15.0,13.0,10.0,3.0
289.0,2014,Sunderland AFC,16.0,2.0,10.0,0,2,3.0,2,2.0,11.0,1.0,1.0,11.0,1,2,5.0,1,1.0,13.0,18.0,0.0,13.0,0,0,7.0,6,1.0,12.0,7.0,2.0,15.0,1,2,5.0,2,2.0,6.0,1.0,0.0,17.0,0,2,7.0,0,0.0,19.0,13.0,0.0,17.0,1,2,1.0,0,0.0,5.0,1.0,3.0,13.0,1,1,7.0,17,1.0,16.0,1.0,0.0,17.0,0,0,7.0,13,8.0,3.0,5.0,0.0,18.0,1,0,7.0,7,2.0,5.0,1.0,3.0,15.0,0,1,7.0,17,1.0,17.0,1.0,1.0,2.0,2.0,3.0,4.0,5.0,8.0,8.0,8.0,11.0,11.0,18.0,-7.0
631.0,2014,Chelsea Football Club,1.0,3.0,1.0,0,1,7.0,17,1.0,19.0,13.0,2.0,3.0,1,1,1.0,7,0.0,16.0,13.0,6.0,1.0,0,1,7.0,31,3.0,17.0,1.0,4.0,1.0,1,1,1.0,24,2.0,3.0,1.0,1.0,1.0,0,2,1.0,1,1.0,6.0,3.0,3.0,1.0,1,1,1.0,8,0.0,6.0,7.0,2.0,1.0,1,1,1.0,7,0.0,8.0,1.0,2.0,1.0,0,1,1.0,16,1.0,16.0,4.0,1.0,1.0,0,2,1.0,1,1.0,8.0,1.0,2.0,1.0,1,1,1.0,16,1.0,19.0,12.0,3.0,6.0,9.0,12.0,13.0,16.0,19.0,22.0,23.0,26.0,26.0,10.0,16.0
148.0,2014,Tottenham Hotspur Football Club,5.0,1.0,6.0,0,1,1.0,6,0.0,16.0,1.0,4.0,1.0,1,1,1.0,9,0.0,20.0,9.0,0.0,6.0,1,0,1.0,8,3.0,5.0,8.0,2.0,6.0,0,2,1.0,2,2.0,15.0,5.0,0.0,9.0,1,0,1.0,6,1.0,16.0,12.0,1.0,8.0,0,2,1.0,1,1.0,4.0,4.0,1.0,6.0,1,1,1.0,6,0.0,3.0,5.0,1.0,9.0,0,0,1.0,18,4.0,2.0,1.0,1.0,11.0,1,0,1.0,16,2.0,14.0,4.0,2.0,8.0,0,1,3.0,16,1.0,16.0,5.0,3.0,6.0,6.0,7.0,7.0,8.0,11.0,11.0,11.0,14.0,13.0,14.0,-1.0
1132.0,2014,Burnley FC,19.0,1.0,19.0,1,0,13.0,17,3.0,1.0,7.0,0.0,19.0,0,0,12.0,6,1.0,4.0,1.0,0.0,20.0,1,2,12.0,0,0.0,14.0,27.0,0.0,18.0,0,2,13.0,0,0.0,17.0,1.0,0.0,19.0,1,2,13.0,0,0.0,17.0,7.0,0.0,20.0,0,0,7.0,9,4.0,10.0,12.0,2.0,19.0,0,2,12.0,2,2.0,12.0,13.0,1.0,19.0,1,0,12.0,17,3.0,4.0,8.0,1.0,20.0,1,0,3.0,17,3.0,9.0,1.0,0.0,20.0,0,0,13.0,8,3.0,4.0,1.0,0.0,0.0,1.0,2.0,3.0,3.0,4.0,4.0,4.0,4.0,5.0,19.0,-14.0
1003.0,2014,Leicester City Football Club,14.0,2.0,12.0,1,2,3.0,2,2.0,9.0,1.0,0.0,16.0,0,0,13.0,7,2.0,3.0,1.0,1.0,16.0,1,2,13.0,1,1.0,7.0,7.0,1.0,12.0,0,1,13.0,6,0.0,14.0,1.0,5.0,7.0,1,1,5.0,30,3.0,12.0,10.0,0.0,12.0,0,0,5.0,7,2.0,9.0,4.0,2.0,12.0,1,2,13.0,2,2.0,19.0,12.0,0.0,15.0,0,0,7.0,6,1.0,18.0,4.0,0.0,17.0,0,0,1.0,7,2.0,6.0,1.0,0.0,18.0,1,0,8.0,6,1.0,11.0,12.0,1.0,1.0,2.0,5.0,8.0,8.0,9.0,9.0,9.0,9.0,11.0,16.0,-5.0
29.0,2014,Everton Football Club,11.0,2.0,9.0,0,2,1.0,2,2.0,12.0,3.0,2.0,10.0,1,2,1.0,2,2.0,5.0,7.0,3.0,17.0,1,0,1.0,31,6.0,1.0,7.0,2.0,11.0,0,1,1.0,7,0.0,19.0,13.0,2.0,14.0,1,0,1.0,23,3.0,15.0,7.0,1.0,15.0,0,2,5.0,1,1.0,14.0,1.0,1.0,17.0,0,0,7.0,16,2.0,4.0,10.0,3.0,13.0,1,1,1.0,8,0.0,12.0,5.0,3.0,9.0,0,1,1.0,17,1.0,20.0,3.0,0.0,9.0,1,2,1.0,0,0.0,6.0,1.0,1.0,2.0,2.0,5.0,5.0,6.0,6.0,9.0,12.0,13.0,19.0,17.0,2.0
281.0,2014,Manchester City Football Club,2.0,2.0,2.0,0,1,3.0,7,0.0,20.0,5.0,3.0,2.0,1,1,12.0,17,1.0,9.0,7.0,0.0,4.0,1,0,3.0,6,1.0,10.0,3.0,2.0,5.0,0,2,1.0,2,2.0,7.0,7.0,1.0,6.0,1,2,3.0,1,1.0,1.0,1.0,4.0,3.0,0,1,3.0,24,2.0,16.0,3.0,2.0,2.0,0,1,3.0,7,0.0,10.0,7.0,4.0,2.0,1,1,1.0,18,1.0,9.0,1.0,1.0,3.0,0,0,3.0,16,2.0,4.0,8.0,1.0,3.0,1,1,12.0,6,0.0,10.0,7.0,3.0,6.0,6.0,7.0,8.0,11.0,14.0,17.0,17.0,20.0,20.0,10.0,10.0
405.0,2014,Aston Villa Football Club,17.0,1.0,7.0,0,1,5.0,6,0.0,17.0,1.0,0.0,7.0,1,2,5.0,0,0.0,17.0,1.0,2.0,3.0,1,1,5.0,16,1.0,9.0,14.0,1.0,2.0,0,1,7.0,6,0.0,8.0,1.0,0.0,3.0,1,0,7.0,8,3.0,4.0,1.0,0.0,6.0,0,0,7.0,8,3.0,1.0,1.0,0.0,10.0,1,0,7.0,7,2.0,2.0,3.0,0.0,12.0,0,0,5.0,8,3.0,13.0,1.0,0.0,15.0,0,0,3.0,7,2.0,19.0,3.0,1.0,16.0,1,0,5.0,16,2.0,8.0,3.0,3.0,4.0,7.0,10.0,10.0,10.0,10.0,10.0,10.0,10.0,5.0,16.0,-11.0
985.0,2014,Manchester United Football Club,4.0,1.0,15.0,1,0,18.0,16,2.0,5.0,1.0,1.0,13.0,0,2,18.0,1,1.0,11.0,5.0,0.0,14.0,0,2,27.0,0,0.0,20.0,12.0,4.0,9.0,1,1,10.0,9,0.0,16.0,7.0,3.0,12.0,0,0,10.0,30,5.0,7.0,5.0,2.0,7.0,1,1,10.0,16,1.0,13.0,1.0,2.0,4.0,1,1,10.0,16,1.0,17.0,7.0,2.0,6.0,0,2,1.0,2,2.0,14.0,12.0,1.0,8.0,1,2,1.0,1,1.0,1.0,1.0,0.0,10.0,0,0,7.0,6,1.0,3.0,12.0,0.0,1.0,2.0,5.0,5.0,8.0,11.0,12.0,13.0,13.0,16.0,14.0,2.0
2288.0,2015,Swansea City,12.0,2.0,13.0,0,2,4.0,2,2.0,10.0,1.0,2.0,6.0,1,1,4.0,7,0.0,15.0,1.0,1.0,6.0,0,2,4.0,1,1.0,19.0,5.0,2.0,4.0,1,1,1.0,16,1.0,5.0,1.0,0.0,8.0,0,0,1.0,6,1.0,13.0,12.0,0.0,7.0,1,2,1.0,0,0.0,6.0,1.0,1.0,11.0,0,0,2.0,17,3.0,10.0,5.0,2.0,11.0,1,2,1.0,2,2.0,8.0,1.0,0.0,14.0,1,0,1.0,6,1.0,11.0,12.0,2.0,12.0,0,1,1.0,16,1.0,20.0,1.0,1.0,4.0,5.0,8.0,8.0,9.0,9.0,10.0,10.0,13.0,12.0,12.0,0.0
989.0,2015,Association Football Club Bournemouth,16.0,0.0,16.0,1,0,3.0,6,1.0,6.0,5.0,0.0,19.0,0,0,12.0,6,1.0,3.0,1.0,4.0,13.0,0,1,3.0,29,3.0,11.0,2.0,1.0,11.0,1,2,12.0,1,1.0,3.0,7.0,1.0,16.0,0,0,1.0,17,3.0,9.0,1.0,2.0,14.0,1,1,3.0,7,0.0,20.0,1.0,1.0,16.0,0,0,12.0,16,2.0,17.0,1.0,1.0,15.0,1,2,12.0,1,1.0,12.0,13.0,1.0,17.0,0,0,1.0,19,5.0,1.0,1.0,1.0,17.0,1,0,3.0,19,5.0,6.0,1.0,0.0,0.0,3.0,4.0,4.0,7.0,7.0,8.0,8.0,8.0,12.0,22.0,-10.0
631.0,2015,Chelsea Football Club,10.0,2.0,10.0,1,2,1.0,2,2.0,13.0,4.0,0.0,17.0,0,0,1.0,8,3.0,1.0,1.0,3.0,10.0,0,1,1.0,23,2.0,20.0,7.0,1.0,13.0,1,0,1.0,16,2.0,2.0,12.0,1.0,17.0,0,0,1.0,17,3.0,7.0,1.0,2.0,15.0,1,1,1.0,7,0.0,5.0,1.0,2.0,14.0,0,2,1.0,2,2.0,19.0,13.0,1.0,16.0,1,0,1.0,17,3.0,9.0,12.0,2.0,12.0,1,1,1.0,7,0.0,19.0,1.0,1.0,15.0,0,0,1.0,16,2.0,3.0,1.0,1.0,1.0,4.0,4.0,4.0,7.0,8.0,8.0,11.0,11.0,15.0,19.0,-4.0
31.0,2015,Liverpool Football Club,8.0,1.0,5.0,0,1,1.0,6,0.0,15.0,7.0,1.0,3.0,1,1,1.0,6,0.0,19.0,12.0,0.0,3.0,0,2,5.0,0,0.0,9.0,1.0,0.0,7.0,1,0,5.0,8,3.0,8.0,7.0,1.0,10.0,0,0,5.0,17,3.0,3.0,1.0,1.0,13.0,1,2,18.0,1,1.0,11.0,7.0,3.0,9.0,1,1,18.0,23,2.0,18.0,2.0,1.0,10.0,0,2,18.0,1,1.0,7.0,7.0,0.0,10.0,0,2,2.0,0,0.0,7.0,1.0,1.0,9.0,1,2,2.0,1,1.0,8.0,1.0,3.0,6.0,7.0,7.0,7.0,8.0,11.0,12.0,13.0,14.0,9.0,11.0,-2.0
762.0,2015,Newcastle United Football Club,18.0,2.0,11.0,1,2,1.0,2,2.0,9.0,1.0,0.0,15.0,0,0,1.0,7,2.0,6.0,4.0,0.0,17.0,0,2,1.0,0,0.0,4.0,1.0,0.0,19.0,1,0,1.0,6,1.0,6.0,1.0,0.0,20.0,0,0,1.0,7,2.0,5.0,1.0,1.0,19.0,1,0,7.0,16,2.0,10.0,12.0,2.0,19.0,1,2,13.0,2,2.0,14.0,1.0,1.0,20.0,0,0,1.0,20,6.0,1.0,1.0,6.0,18.0,1,1,13.0,26,2.0,16.0,1.0,0.0,19.0,0,0,13.0,8,3.0,18.0,1.0,1.0,1.0,2.0,2.0,2.0,2.0,3.0,3.0,6.0,6.0,12.0,22.0,-10.0
512.0,2015,Stoke City,9.0,0.0,15.0,1,0,7.0,6,1.0,5.0,1.0,2.0,14.0,0,2,7.0,2,2.0,13.0,1.0,1.0,16.0,0,2,1.0,1,1.0,8.0,12.0,0.0,18.0,1,0,4.0,6,1.0,15.0,7.0,0.0,18.0,0,0,3.0,7,2.0,4.0,1.0,2.0,18.0,1,2,1.0,2,2.0,4.0,13.0,2.0,17.0,1,1,1.0,16,1.0,16.0,12.0,1.0,14.0,0,1,1.0,6,0.0,18.0,17.0,1.0,11.0,0,1,12.0,6,0.0,14.0,1.0,0.0,14.0,1,0,1.0,7,2.0,13.0,12.0,0.0,1.0,2.0,2.0,2.0,3.0,6.0,9.0,12.0,12.0,9.0,12.0,-3.0
11.0,2015,Arsenal Football Club,2.0,0.0,19.0,1,0,1.0,7,2.0,4.0,8.0,2.0,11.0,0,1,1.0,16,1.0,7.0,1.0,0.0,9.0,1,2,1.0,0,0.0,3.0,5.0,1.0,6.0,0,1,1.0,6,0.0,19.0,1.0,2.0,4.0,1,1,1.0,7,0.0,18.0,3.0,0.0,5.0,0,0,1.0,7,2.0,15.0,1.0,5.0,4.0,0,1,1.0,25,2.0,8.0,12.0,3.0,2.0,1,1,1.0,8,0.0,3.0,1.0,3.0,2.0,0,1,1.0,8,0.0,15.0,3.0,2.0,2.0,1,1,1.0,16,1.0,11.0,5.0,0.0,3.0,4.0,7.0,10.0,10.0,13.0,16.0,19.0,22.0,18.0,8.0,10.0
1003.0,2015,Leicester City Football Club,1.0,4.0,2.0,1,1,3.0,24,2.0,17.0,5.0,2.0,2.0,0,1,3.0,16,1.0,8.0,8.0,1.0,2.0,1,2,3.0,1,1.0,15.0,1.0,1.0,3.0,0,2,7.0,1,1.0,11.0,12.0,3.0,2.0,1,1,13.0,23,2.0,15.0,1.0,2.0,4.0,0,2,13.0,2,2.0,18.0,1.0,2.0,8.0,1,0,12.0,25,5.0,4.0,1.0,2.0,5.0,0,1,12.0,16,1.0,13.0,1.0,2.0,5.0,0,2,13.0,2,2.0,8.0,5.0,1.0,5.0,1,1,12.0,6,0.0,7.0,3.0,3.0,6.0,7.0,8.0,11.0,12.0,12.0,15.0,16.0,19.0,20.0,17.0,3.0
873.0,2015,Crystal Palace Football Club,15.0,3.0,3.0,0,1,4.0,17,1.0,18.0,12.0,1.0,7.0,1,0,1.0,16,2.0,11.0,1.0,2.0,5.0,1,1,1.0,16,1.0,14.0,5.0,2.0,2.0,0,1,12.0,16,1.0,13.0,1.0,0.0,6.0,1,0,1.0,6,1.0,1.0,3.0,0.0,8.0,0,0,4.0,6,1.0,9.0,1.0,1.0,7.0,0,1,3.0,6,0.0,13.0,3.0,2.0,4.0,1,1,1.0,7,0.0,17.0,5.0,1.0,6.0,1,0,1.0,17,3.0,4.0,1.0,0.0,7.0,0,0,3.0,6,1.0,5.0,12.0,3.0,3.0,6.0,9.0,9.0,9.0,12.0,15.0,15.0,15.0,12.0,11.0,1.0
1123.0,2015,Norwich City,19.0,1.0,18.0,1,0,12.0,17,3.0,3.0,4.0,3.0,9.0,0,1,1.0,17,1.0,20.0,3.0,1.0,8.0,1,2,12.0,1,1.0,16.0,1.0,0.0,14.0,0,0,12.0,8,3.0,10.0,4.0,3.0,9.0,1,1,1.0,17,1.0,16.0,1.0,1.0,11.0,0,2,7.0,1,1.0,13.0,18.0,2.0,12.0,0,2,12.0,2,2.0,3.0,1.0,1.0,13.0,1,0,1.0,16,2.0,5.0,12.0,2.0,16.0,0,0,1.0,26,6.0,18.0,13.0,0.0,16.0,1,0,1.0,6,1.0,10.0,3.0,0.0,3.0,4.0,4.0,7.0,8.0,9.0,9.0,9.0,9.0,14.0,21.0,-7.0
405.0,2015,Aston Villa Football Club,20.0,1.0,6.0,0,1,5.0,6,0.0,16.0,3.0,0.0,10.0,1,0,5.0,6,1.0,4.0,1.0,1.0,14.0,0,0,5.0,16,2.0,5.0,1.0,2.0,12.0,1,2,6.0,2,2.0,20.0,5.0,2.0,15.0,0,0,1.0,23,3.0,2.0,13.0,0.0,17.0,1,0,12.0,6,1.0,12.0,7.0,2.0,18.0,0,0,2.0,23,3.0,9.0,18.0,0.0,18.0,1,0,17.0,6,1.0,14.0,1.0,0.0,19.0,0,0,1.0,7,2.0,12.0,1.0,1.0,20.0,1,0,1.0,16,2.0,12.0,1.0,3.0,3.0,3.0,4.0,4.0,4.0,4.0,4.0,4.0,4.0,9.0,17.0,-8.0
289.0,2015,Sunderland AFC,17.0,2.0,17.0,0,0,5.0,24,4.0,2.0,3.0,1.0,20.0,1,0,3.0,17,3.0,9.0,1.0,1.0,19.0,1,2,5.0,1,1.0,6.0,4.0,2.0,20.0,0,2,5.0,2,2.0,12.0,6.0,0.0,19.0,1,0,4.0,6,1.0,12.0,1.0,0.0,20.0,0,0,1.0,7,2.0,14.0,3.0,0.0,20.0,0,0,12.0,8,3.0,1.0,1.0,2.0,19.0,1,2,1.0,2,2.0,6.0,1.0,0.0,20.0,0,0,1.0,6,1.0,13.0,3.0,3.0,18.0,1,1,1.0,8,0.0,19.0,13.0,0.0,0.0,1.0,2.0,2.0,2.0,2.0,3.0,3.0,6.0,11.0,19.0,-8.0
148.0,2015,Tottenham Hotspur Football Club,3.0,0.0,14.0,0,0,1.0,6,1.0,7.0,1.0,2.0,13.0,1,2,1.0,2,2.0,14.0,7.0,1.0,15.0,0,2,1.0,1,1.0,2.0,3.0,0.0,16.0,1,2,1.0,0,0.0,9.0,12.0,1.0,12.0,0,1,1.0,6,0.0,19.0,4.0,1.0,9.0,1,1,1.0,6,0.0,8.0,4.0,4.0,6.0,1,1,1.0,18,1.0,2.0,1.0,2.0,8.0,0,2,1.0,2,2.0,11.0,1.0,0.0,7.0,1,2,1.0,0,0.0,10.0,2.0,5.0,6.0,0,1,1.0,19,1.0,17.0,3.0,0.0,1.0,2.0,3.0,6.0,9.0,12.0,13.0,14.0,17.0,16.0,8.0,8.0
29.0,2015,Everton Football Club,11.0,2.0,8.0,1,2,1.0,2,2.0,12.0,12.0,3.0,5.0,0,1,12.0,8,0.0,16.0,1.0,0.0,7.0,1,0,1.0,7,2.0,1.0,1.0,0.0,9.0,0,2,12.0,0,0.0,16.0,1.0,3.0,7.0,1,1,1.0,17,1.0,17.0,1.0,0.0,6.0,0,2,1.0,0,0.0,7.0,1.0,3.0,5.0,0,1,5.0,23,2.0,15.0,5.0,1.0,7.0,1,2,7.0,1,1.0,10.0,18.0,0.0,9.0,1,0,1.0,8,3.0,3.0,1.0,1.0,11.0,0,0,5.0,16,2.0,2.0,1.0,1.0,4.0,4.0,5.0,8.0,9.0,12.0,13.0,13.0,13.0,13.0,13.0,0.0
180.0,2015,Southampton Football Club,6.0,2.0,9.0,0,2,1.0,2,2.0,11.0,1.0,0.0,16.0,1,0,1.0,8,3.0,5.0,12.0,0.0,18.0,0,2,17.0,0,0.0,12.0,12.0,3.0,10.0,1,1,4.0,8,0.0,14.0,12.0,0.0,11.0,0,2,1.0,0,0.0,14.0,3.0,2.0,16.0,1,0,4.0,23,3.0,2.0,1.0,3.0,10.0,1,1,5.0,17,1.0,11.0,2.0,3.0,9.0,0,1,12.0,17,1.0,16.0,1.0,2.0,8.0,1,2,5.0,2,2.0,5.0,13.0,1.0,8.0,0,2,1.0,1,1.0,9.0,2.0,1.0,1.0,2.0,5.0,6.0,6.0,9.0,12.0,13.0,14.0,16.0,13.0,3.0
984.0,2015,West Bromwich Albion,14.0,0.0,20.0,1,0,13.0,8,3.0,1.0,1.0,0.0,18.0,0,2,13.0,0,0.0,12.0,3.0,2.0,20.0,1,0,7.0,23,3.0,10.0,1.0,1.0,15.0,0,1,7.0,6,0.0,18.0,4.0,0.0,14.0,1,2,3.0,0,0.0,11.0,1.0,1.0,12.0,0,1,7.0,6,0.0,17.0,12.0,2.0,15.0,1,0,5.0,23,3.0,5.0,5.0,0.0,17.0,0,0,5.0,7,2.0,4.0,1.0,1.0,13.0,1,1,3.0,6,0.0,20.0,1.0,1.0,10.0,0,1,3.0,6,0.0,16.0,1.0,0.0,1.0,1.0,4.0,5.0,8.0,8.0,8.0,11.0,14.0,8.0,11.0,-3.0
281.0,2015,Manchester City Football Club,4.0,3.0,1.0,0,1,1.0,8,0.0,20.0,13.0,3.0,1.0,1,1,1.0,8,0.0,17.0,1.0,2.0,1.0,0,1,1.0,7,0.0,7.0,1.0,2.0,1.0,1,1,1.0,7,0.0,17.0,8.0,1.0,1.0,0,1,3.0,6,0.0,6.0,1.0,1.0,1.0,1,0,1.0,16,2.0,3.0,1.0,1.0,2.0,0,0,1.0,18,4.0,6.0,1.0,6.0,1.0,1,1,1.0,20,1.0,20.0,1.0,5.0,1.0,1,1,1.0,19,1.0,17.0,1.0,0.0,1.0,0,2,1.0,0,0.0,4.0,1.0,3.0,6.0,9.0,12.0,15.0,15.0,15.0,18.0,21.0,22.0,24.0,8.0,16.0
379.0,2015,West Ham United Football Club,7.0,2.0,4.0,0,1,8.0,7,0.0,19.0,1.0,1.0,8.0,1,0,8.0,16,2.0,2.0,3.0,3.0,11.0,1,0,2.0,29,4.0,13.0,3.0,3.0,8.0,0,1,7.0,8,0.0,7.0,5.0,2.0,5.0,1,1,1.0,7,0.0,20.0,1.0,2.0,3.0,0,1,1.0,16,1.0,1.0,1.0,2.0,3.0,1,2,1.0,2,2.0,12.0,12.0,2.0,6.0,0,2,1.0,2,2.0,19.0,1.0,3.0,4.0,0,1,1.0,17,1.0,6.0,1.0,2.0,3.0,1,1,1.0,16,1.0,15.0,1.0,3.0,3.0,3.0,6.0,9.0,12.0,13.0,14.0,17.0,20.0,22.0,13.0,9.0
985.0,2015,Manchester United Football Club,5.0,1.0,7.0,1,1,1.0,6,0.0,14.0,1.0,1.0,4.0,0,1,1.0,6,0.0,10.0,5.0,0.0,4.0,1,2,1.0,0,0.0,17.0,1.0,1.0,5.0,0,0,1.0,16,2.0,4.0,1.0,3.0,3.0,1,1,1.0,17,1.0,10.0,5.0,3.0,2.0,0,1,1.0,23,2.0,16.0,4.0,3.0,1.0,1,1,1.0,8,0.0,20.0,12.0,0.0,3.0,0,0,1.0,8,3.0,2.0,1.0,3.0,3.0,0,1,1.0,8,0.0,9.0,1.0,0.0,4.0,1,2,1.0,0,0.0,1.0,1.0,3.0,6.0,7.0,7.0,10.0,13.0,16.0,16.0,19.0,20.0,15.0,8.0,7.0
1010.0,2015,Watford FC,13.0,2.0,12.0,0,2,12.0,2,2.0,8.0,1.0,0.0,12.0,1,2,3.0,0,0.0,18.0,13.0,0.0,12.0,1,2,12.0,0,0.0,18.0,17.0,0.0,17.0,0,0,8.0,7,2.0,1.0,1.0,1.0,13.0,1,1,12.0,6,0.0,8.0,1.0,2.0,10.0,0,1,12.0,16,1.0,19.0,7.0,0.0,13.0,1,0,3.0,6,1.0,7.0,3.0,1.0,12.0,0,2,13.0,1,1.0,15.0,12.0,0.0,15.0,1,0,3.0,8,3.0,2.0,1.0,2.0,13.0,0,1,12.0,7,0.0,14.0,1.0,1.0,2.0,3.0,3.0,6.0,9.0,9.0,10.0,10.0,13.0,8.0,10.0,-2.0
985.0,2016,Manchester United Football Club,6.0,3.0,1.0,0,1,1.0,17,1.0,20.0,7.0,2.0,2.0,1,1,1.0,7,0.0,16.0,8.0,1.0,3.0,0,1,1.0,6,0.0,5.0,7.0,1.0,4.0,1,0,1.0,16,2.0,1.0,7.0,1.0,7.0,0,0,1.0,17,3.0,9.0,25.0,4.0,6.0,1,1,1.0,18,1.0,12.0,3.0,1.0,6.0,1,2,1.0,1,1.0,19.0,1.0,0.0,7.0,0,2,1.0,0,0.0,4.0,5.0,0.0,7.0,0,0,6.0,9,4.0,4.0,14.0,0.0,8.0,1,2,1.0,0,0.0,14.0,3.0,3.0,6.0,9.0,9.0,9.0,12.0,13.0,14.0,14.0,15.0,13.0,12.0,1.0
984.0,2016,West Bromwich Albion,10.0,1.0,6.0,0,1,3.0,6,0.0,18.0,1.0,1.0,10.0,1,0,12.0,16,2.0,5.0,18.0,0.0,10.0,1,2,7.0,0,0.0,7.0,1.0,0.0,12.0,0,0,7.0,6,1.0,14.0,1.0,4.0,10.0,1,1,7.0,24,2.0,18.0,1.0,1.0,10.0,0,2,7.0,1,1.0,19.0,4.0,1.0,9.0,0,2,1.0,1,1.0,20.0,8.0,1.0,12.0,1,2,7.0,1,1.0,3.0,7.0,1.0,13.0,0,0,1.0,16,2.0,3.0,7.0,0.0,16.0,1,0,7.0,9,4.0,1.0,7.0,3.0,3.0,4.0,4.0,7.0,8.0,9.0,10.0,10.0,10.0,10.0,14.0,-4.0
11.0,2016,Arsenal Football Club,5.0,3.0,14.0,1,0,1.0,29,4.0,2.0,5.0,0.0,13.0,0,2,1.0,0,0.0,15.0,13.0,3.0,8.0,0,1,1.0,17,1.0,18.0,9.0,2.0,7.0,1,1,1.0,16,1.0,18.0,8.0,4.0,4.0,0,1,1.0,18,1.0,12.0,5.0,3.0,3.0,1,1,1.0,8,0.0,8.0,7.0,1.0,3.0,0,1,1.0,6,0.0,14.0,6.0,3.0,2.0,1,1,1.0,23,2.0,19.0,1.0,0.0,2.0,1,2,1.0,0,0.0,17.0,7.0,4.0,2.0,0,1,1.0,18,1.0,20.0,5.0,0.0,1.0,4.0,7.0,10.0,13.0,16.0,19.0,20.0,23.0,23.0,10.0,13.0
631.0,2016,Chelsea Football Club,1.0,2.0,4.0,1,1,7.0,16,1.0,16.0,7.0,2.0,4.0,0,1,7.0,16,1.0,14.0,27.0,3.0,2.0,1,1,5.0,8,0.0,13.0,13.0,2.0,2.0,0,2,1.0,2,2.0,13.0,23.0,1.0,5.0,1,0,1.0,16,2.0,6.0,7.0,0.0,8.0,0,0,7.0,8,3.0,3.0,1.0,2.0,7.0,0,1,14.0,7,0.0,15.0,1.0,3.0,5.0,1,1,14.0,8,0.0,13.0,12.0,4.0,4.0,1,1,14.0,9,0.0,7.0,6.0,2.0,4.0,0,1,14.0,7,0.0,9.0,5.0,3.0,6.0,9.0,10.0,10.0,10.0,13.0,16.0,19.0,22.0,21.0,9.0,12.0
379.0,2016,West Ham United Football Club,11.0,1.0,16.0,0,0,7.0,16,2.0,4.0,7.0,1.0,9.0,1,1,6.0,6,0.0,20.0,12.0,1.0,12.0,0,0,22.0,17,3.0,1.0,5.0,2.0,17.0,1,0,1.0,24,4.0,10.0,17.0,2.0,18.0,0,0,1.0,24,4.0,10.0,7.0,0.0,18.0,1,0,5.0,8,3.0,9.0,8.0,1.0,18.0,1,2,5.0,1,1.0,16.0,13.0,1.0,15.0,0,1,14.0,6,0.0,9.0,5.0,1.0,15.0,1,1,14.0,6,0.0,20.0,3.0,0.0,17.0,0,0,14.0,7,2.0,6.0,1.0,0.0,3.0,3.0,3.0,3.0,3.0,4.0,7.0,10.0,10.0,10.0,19.0,-9.0
2288.0,2016,Swansea City,15.0,1.0,7.0,0,1,5.0,6,0.0,19.0,13.0,0.0,12.0,1,0,1.0,7,2.0,3.0,5.0,1.0,14.0,0,0,5.0,16,2.0,9.0,3.0,2.0,13.0,1,2,23.0,2,2.0,2.0,1.0,0.0,15.0,0,0,5.0,6,1.0,14.0,8.0,1.0,17.0,1,0,5.0,17,3.0,1.0,1.0,1.0,17.0,1,0,5.0,16,2.0,4.0,5.0,2.0,19.0,0,0,1.0,23,3.0,2.0,1.0,0.0,19.0,1,2,1.0,0,0.0,9.0,17.0,1.0,19.0,0,0,1.0,17,3.0,12.0,1.0,3.0,3.0,3.0,4.0,4.0,4.0,4.0,4.0,5.0,5.0,9.0,18.0,-9.0
1132.0,2016,Burnley FC,16.0,0.0,19.0,1,0,13.0,6,1.0,7.0,5.0,2.0,8.0,1,1,13.0,7,0.0,11.0,5.0,0.0,13.0,0,0,13.0,8,3.0,2.0,5.0,1.0,15.0,1,2,13.0,1,1.0,8.0,7.0,0.0,16.0,0,0,6.0,8,3.0,11.0,3.0,2.0,13.0,1,1,6.0,7,0.0,11.0,17.0,0.0,14.0,1,0,6.0,6,1.0,3.0,1.0,1.0,14.0,0,0,6.0,17,3.0,8.0,7.0,2.0,14.0,1,1,6.0,16,1.0,6.0,5.0,0.0,14.0,0,2,3.0,0,0.0,8.0,1.0,0.0,3.0,3.0,4.0,4.0,7.0,7.0,7.0,10.0,11.0,8.0,13.0,-5.0
29.0,2016,Everton Football Club,7.0,1.0,8.0,1,2,14.0,1,1.0,9.0,1.0,2.0,5.0,0,1,18.0,16,1.0,10.0,12.0,1.0,4.0,1,1,1.0,6,0.0,20.0,7.0,3.0,3.0,0,1,1.0,8,0.0,19.0,1.0,3.0,2.0,1,1,1.0,17,1.0,13.0,1.0,0.0,5.0,0,0,1.0,6,1.0,15.0,7.0,1.0,5.0,1,2,3.0,1,1.0,8.0,7.0,1.0,6.0,0,2,3.0,1,1.0,1.0,14.0,1.0,6.0,0,0,5.0,16,2.0,14.0,6.0,2.0,6.0,1,1,1.0,7,0.0,17.0,14.0,1.0,4.0,7.0,10.0,13.0,13.0,14.0,15.0,15.0,18.0,15.0,8.0,7.0
31.0,2016,Liverpool Football Club,4.0,4.0,2.0,0,1,5.0,29,3.0,14.0,1.0,0.0,11.0,0,0,5.0,7,2.0,8.0,13.0,1.0,11.0,0,2,5.0,1,1.0,6.0,1.0,4.0,6.0,1,1,5.0,18,1.0,16.0,12.0,2.0,6.0,0,1,7.0,16,1.0,5.0,1.0,5.0,4.0,1,1,7.0,19,1.0,14.0,7.0,2.0,4.0,0,1,5.0,16,1.0,17.0,5.0,0.0,4.0,1,2,5.0,0,0.0,7.0,1.0,2.0,3.0,1,1,7.0,16,1.0,13.0,1.0,4.0,3.0,0,1,1.0,24,2.0,13.0,1.0,3.0,3.0,4.0,7.0,10.0,13.0,16.0,17.0,20.0,23.0,24.0,13.0,11.0
873.0,2016,Crystal Palace Football Club,14.0,0.0,18.0,1,0,1.0,6,1.0,6.0,3.0,0.0,19.0,0,0,1.0,6,1.0,7.0,3.0,1.0,17.0,1,2,3.0,1,1.0,19.0,12.0,2.0,11.0,0,1,1.0,16,1.0,9.0,1.0,4.0,8.0,1,1,1.0,18,1.0,20.0,1.0,3.0,7.0,0,1,1.0,23,2.0,20.0,5.0,1.0,8.0,0,2,7.0,1,1.0,5.0,3.0,0.0,9.0,1,0,5.0,6,1.0,15.0,14.0,1.0,11.0,0,0,7.0,17,3.0,12.0,3.0,2.0,13.0,1,0,1.0,24,4.0,3.0,1.0,0.0,0.0,1.0,4.0,7.0,10.0,11.0,11.0,11.0,11.0,14.0,16.0,-2.0
989.0,2016,Association Football Club Bournemouth,9.0,1.0,20.0,1,0,7.0,17,3.0,1.0,1.0,0.0,20.0,0,0,12.0,6,1.0,9.0,6.0,1.0,19.0,0,2,12.0,1,1.0,17.0,3.0,1.0,14.0,1,1,1.0,6,0.0,12.0,7.0,0.0,17.0,0,0,7.0,9,4.0,1.0,7.0,1.0,15.0,1,1,7.0,6,0.0,5.0,1.0,2.0,13.0,0,2,6.0,2,2.0,11.0,5.0,6.0,11.0,1,1,1.0,20,1.0,16.0,1.0,0.0,10.0,1,2,1.0,0,0.0,5.0,1.0,0.0,10.0,0,0,1.0,7,2.0,15.0,1.0,0.0,0.0,1.0,4.0,4.0,7.0,8.0,11.0,12.0,12.0,12.0,14.0,-2.0
512.0,2016,Stoke City,13.0,1.0,11.0,0,2,1.0,1,1.0,12.0,1.0,1.0,17.0,1,0,7.0,18,4.0,1.0,7.0,0.0,20.0,0,0,7.0,6,1.0,4.0,1.0,0.0,20.0,1,0,1.0,9,4.0,5.0,1.0,1.0,20.0,0,0,1.0,18,4.0,8.0,1.0,1.0,19.0,1,2,4.0,1,1.0,10.0,7.0,1.0,19.0,0,2,1.0,1,1.0,6.0,1.0,2.0,18.0,1,1,1.0,7,0.0,20.0,8.0,2.0,16.0,0,1,1.0,7,0.0,18.0,1.0,3.0,12.0,1,1,1.0,17,1.0,19.0,1.0,1.0,1.0,1.0,1.0,1.0,2.0,3.0,6.0,9.0,12.0,12.0,17.0,-5.0
641.0,2016,Middlesbrough FC,19.0,1.0,12.0,1,2,1.0,1,1.0,11.0,1.0,2.0,6.0,0,1,1.0,16,1.0,18.0,5.0,0.0,7.0,0,2,1.0,0,0.0,10.0,7.0,1.0,9.0,1,0,1.0,16,2.0,11.0,1.0,1.0,13.0,0,0,1.0,17,3.0,2.0,1.0,1.0,16.0,1,0,1.0,16,2.0,2.0,7.0,1.0,16.0,0,2,13.0,1,1.0,18.0,5.0,0.0,17.0,1,0,1.0,6,1.0,10.0,14.0,0.0,17.0,0,2,7.0,0,0.0,2.0,1.0,2.0,15.0,1,1,1.0,7,0.0,10.0,1.0,1.0,4.0,5.0,5.0,5.0,5.0,6.0,6.0,7.0,10.0,9.0,11.0,-2.0
289.0,2016,Sunderland AFC,20.0,1.0,15.0,0,0,12.0,16,2.0,3.0,7.0,1.0,18.0,1,0,5.0,16,2.0,6.0,1.0,1.0,16.0,0,2,7.0,1,1.0,15.0,8.0,0.0,19.0,1,0,1.0,8,3.0,3.0,1.0,0.0,19.0,0,0,7.0,6,1.0,3.0,1.0,2.0,20.0,1,0,5.0,23,3.0,7.0,1.0,1.0,20.0,1,2,8.0,1,1.0,9.0,1.0,0.0,20.0,0,0,8.0,7,2.0,18.0,1.0,0.0,20.0,0,0,3.0,6,1.0,15.0,14.0,1.0,20.0,1,0,5.0,18,4.0,2.0,1.0,0.0,0.0,1.0,1.0,1.0,1.0,2.0,2.0,2.0,2.0,7.0,20.0,-13.0
1010.0,2016,Watford FC,17.0,1.0,13.0,0,2,9.0,1,1.0,10.0,8.0,1.0,14.0,1,0,27.0,16,2.0,4.0,7.0,1.0,18.0,1,0,9.0,17,3.0,8.0,1.0,4.0,10.0,0,1,17.0,24,2.0,17.0,1.0,3.0,9.0,1,1,25.0,17,1.0,7.0,1.0,0.0,11.0,0,0,17.0,7,2.0,13.0,6.0,2.0,11.0,1,2,5.0,2,2.0,13.0,6.0,1.0,10.0,0,1,14.0,6,0.0,17.0,1.0,0.0,9.0,0,2,17.0,0,0.0,19.0,1.0,1.0,7.0,1,1,9.0,6,0.0,18.0,9.0,1.0,1.0,1.0,4.0,7.0,7.0,8.0,11.0,12.0,15.0,14.0,13.0,1.0
1003.0,2016,Leicester City Football Club,12.0,1.0,17.0,0,0,3.0,16,2.0,5.0,5.0,0.0,15.0,1,2,13.0,0,0.0,13.0,1.0,2.0,9.0,1,1,3.0,16,1.0,14.0,5.0,1.0,16.0,0,0,12.0,18,4.0,6.0,5.0,3.0,11.0,1,1,3.0,8,0.0,16.0,6.0,1.0,12.0,0,0,3.0,18,4.0,6.0,1.0,0.0,12.0,1,2,3.0,0,0.0,10.0,8.0,0.0,13.0,0,0,12.0,8,3.0,5.0,14.0,3.0,12.0,1,1,3.0,17,1.0,11.0,7.0,1.0,11.0,0,2,3.0,1,1.0,5.0,1.0,0.0,1.0,4.0,4.0,7.0,7.0,8.0,8.0,11.0,12.0,12.0,16.0,-4.0
148.0,2016,Tottenham Hotspur Football Club,2.0,1.0,9.0,0,2,1.0,1,1.0,8.0,14.0,1.0,7.0,1,1,3.0,6,0.0,19.0,1.0,1.0,6.0,1,2,1.0,1,1.0,11.0,5.0,4.0,5.0,0,1,1.0,9,0.0,20.0,1.0,1.0,3.0,1,1,1.0,6,0.0,19.0,7.0,2.0,2.0,0,1,7.0,16,1.0,16.0,1.0,2.0,2.0,1,1,1.0,7,0.0,1.0,1.0,1.0,3.0,0,2,7.0,1,1.0,12.0,7.0,0.0,5.0,0,2,1.0,0,0.0,10.0,1.0,1.0,5.0,1,2,1.0,1,1.0,11.0,3.0,1.0,4.0,5.0,8.0,11.0,14.0,17.0,18.0,19.0,20.0,14.0,5.0,9.0
3008.0,2016,Hull City,18.0,2.0,5.0,1,1,5.0,16,1.0,17.0,3.0,2.0,3.0,0,1,5.0,7,0.0,12.0,1.0,0.0,5.0,1,0,7.0,6,1.0,3.0,1.0,1.0,8.0,0,2,7.0,1,1.0,15.0,13.0,1.0,12.0,1,0,5.0,18,4.0,4.0,1.0,1.0,14.0,0,0,7.0,19,5.0,4.0,7.0,0.0,15.0,1,0,1.0,7,2.0,7.0,14.0,1.0,16.0,0,0,1.0,20,6.0,11.0,1.0,0.0,18.0,1,0,1.0,7,2.0,16.0,1.0,0.0,18.0,0,0,9.0,6,1.0,7.0,9.0,3.0,6.0,6.0,7.0,7.0,7.0,7.0,7.0,7.0,7.0,8.0,23.0,-15.0
180.0,2016,Southampton Football Club,8.0,1.0,10.0,1,2,8.0,1,1.0,13.0,9.0,0.0,16.0,0,0,8.0,7,2.0,2.0,1.0,1.0,15.0,1,2,8.0,1,1.0,16.0,7.0,1.0,18.0,0,0,8.0,16,2.0,7.0,1.0,1.0,14.0,1,1,8.0,6,0.0,15.0,5.0,3.0,9.0,0,1,8.0,8,0.0,18.0,5.0,0.0,10.0,0,2,8.0,0,0.0,12.0,3.0,3.0,8.0,1,1,7.0,17,1.0,14.0,6.0,1.0,8.0,0,2,8.0,1,1.0,1.0,18.0,0.0,9.0,1,0,5.0,7,2.0,4.0,14.0,1.0,1.0,2.0,2.0,5.0,8.0,9.0,12.0,13.0,13.0,11.0,10.0,1.0
281.0,2016,Manchester City Football Club,3.0,2.0,3.0,1,1,7.0,16,1.0,15.0,12.0,4.0,1.0,0,1,7.0,18,1.0,17.0,7.0,3.0,1.0,1,1,5.0,17,1.0,12.0,22.0,2.0,1.0,0,1,7.0,16,1.0,4.0,1.0,4.0,1.0,1,1,7.0,9,0.0,17.0,7.0,3.0,1.0,0,1,1.0,17,1.0,17.0,5.0,0.0,1.0,0,0,1.0,7,2.0,2.0,1.0,1.0,1.0,1,2,14.0,1,1.0,6.0,3.0,1.0,1.0,1,2,18.0,1,1.0,8.0,8.0,4.0,1.0,0,1,7.0,9,0.0,16.0,7.0,3.0,6.0,9.0,12.0,15.0,18.0,18.0,19.0,20.0,23.0,24.0,9.0,15.0
1237.0,2017,Brighton and Hove Albion Football Club,15.0,0.0,18.0,1,0,5.0,7,2.0,4.0,27.0,0.0,19.0,0,0,12.0,7,2.0,9.0,12.0,0.0,17.0,0,2,12.0,0,0.0,7.0,5.0,3.0,14.0,1,1,12.0,17,1.0,9.0,7.0,1.0,16.0,0,0,13.0,16,2.0,19.0,3.0,1.0,13.0,1,1,13.0,6,0.0,10.0,1.0,0.0,14.0,0,0,7.0,7,2.0,5.0,14.0,1.0,14.0,1,2,12.0,1,1.0,16.0,1.0,3.0,12.0,0,1,3.0,8,0.0,16.0,1.0,1.0,12.0,1,2,3.0,1,1.0,10.0,7.0,0.0,0.0,1.0,4.0,4.0,7.0,7.0,8.0,11.0,12.0,10.0,11.0,-1.0
631.0,2017,Chelsea Football Club,5.0,2.0,14.0,1,0,14.0,23,3.0,6.0,6.0,2.0,11.0,0,1,9.0,16,1.0,10.0,2.0,2.0,6.0,1,1,14.0,7,0.0,12.0,14.0,2.0,3.0,0,1,14.0,16,1.0,17.0,3.0,0.0,3.0,1,2,22.0,0,0.0,12.0,22.0,4.0,3.0,0,1,22.0,9,0.0,16.0,22.0,0.0,4.0,1,0,17.0,6,1.0,1.0,7.0,1.0,5.0,0,0,14.0,16,2.0,20.0,13.0,4.0,4.0,1,1,11.0,24,2.0,6.0,11.0,1.0,4.0,0,1,14.0,6,0.0,19.0,13.0,0.0,3.0,6.0,9.0,10.0,13.0,13.0,13.0,16.0,19.0,18.0,10.0,8.0
1110.0,2017,Huddersfield Town,16.0,3.0,2.0,0,1,1.0,8,0.0,19.0,14.0,1.0,2.0,1,1,7.0,6,0.0,17.0,1.0,0.0,3.0,1,2,1.0,0,0.0,8.0,4.0,0.0,6.0,0,0,1.0,7,2.0,18.0,14.0,1.0,6.0,1,2,7.0,1,1.0,15.0,12.0,0.0,8.0,0,2,7.0,0,0.0,9.0,6.0,0.0,11.0,1,0,7.0,9,4.0,3.0,14.0,0.0,12.0,0,0,1.0,7,2.0,13.0,7.0,2.0,11.0,1,1,7.0,16,1.0,2.0,1.0,0.0,13.0,0,0,12.0,8,3.0,6.0,7.0,3.0,6.0,7.0,7.0,8.0,9.0,9.0,9.0,12.0,12.0,7.0,13.0,-6.0
281.0,2017,Manchester City Football Club,1.0,2.0,4.0,0,1,27.0,7,0.0,18.0,5.0,1.0,5.0,1,2,9.0,1,1.0,8.0,18.0,2.0,4.0,0,1,5.0,16,1.0,18.0,17.0,5.0,2.0,1,1,27.0,10,0.0,8.0,5.0,6.0,1.0,0,1,5.0,11,0.0,11.0,5.0,5.0,1.0,1,1,5.0,10,0.0,20.0,1.0,1.0,1.0,0,1,7.0,6,0.0,4.0,17.0,7.0,1.0,1,1,5.0,27,2.0,17.0,10.0,3.0,1.0,1,1,7.0,8,0.0,8.0,7.0,3.0,1.0,0,1,5.0,23,2.0,15.0,9.0,3.0,4.0,7.0,10.0,13.0,16.0,19.0,22.0,25.0,28.0,35.0,6.0,29.0
31.0,2017,Liverpool Football Club,4.0,3.0,9.0,0,2,5.0,3,3.0,10.0,5.0,1.0,6.0,1,1,1.0,6,0.0,18.0,11.0,4.0,2.0,1,1,5.0,9,0.0,16.0,14.0,0.0,8.0,0,0,5.0,10,5.0,2.0,27.0,1.0,8.0,1,2,7.0,1,1.0,7.0,12.0,3.0,5.0,0,1,5.0,23,2.0,17.0,12.0,1.0,7.0,0,2,7.0,1,1.0,9.0,1.0,0.0,8.0,1,2,1.0,0,0.0,2.0,1.0,1.0,9.0,0,0,5.0,18,4.0,3.0,9.0,3.0,6.0,1,1,7.0,8,0.0,13.0,12.0,1.0,4.0,7.0,7.0,8.0,11.0,12.0,13.0,13.0,16.0,17.0,16.0,1.0
180.0,2017,Southampton Football Club,17.0,0.0,11.0,1,2,1.0,0,0.0,12.0,5.0,3.0,7.0,1,1,4.0,23,2.0,20.0,4.0,0.0,8.0,0,2,4.0,0,0.0,3.0,1.0,0.0,13.0,1,0,1.0,7,2.0,4.0,7.0,1.0,9.0,0,1,1.0,6,0.0,20.0,1.0,0.0,11.0,1,0,1.0,6,1.0,2.0,1.0,1.0,12.0,0,0,1.0,16,2.0,13.0,22.0,2.0,11.0,1,2,3.0,2,2.0,9.0,1.0,1.0,10.0,1,1,8.0,6,0.0,13.0,7.0,1.0,10.0,0,2,7.0,1,1.0,12.0,3.0,1.0,4.0,5.0,5.0,8.0,8.0,8.0,9.0,12.0,13.0,9.0,10.0,-1.0
984.0,2017,West Bromwich Albion,20.0,1.0,8.0,1,1,7.0,6,0.0,15.0,12.0,1.0,3.0,0,1,7.0,6,0.0,13.0,7.0,1.0,5.0,1,2,7.0,1,1.0,11.0,11.0,1.0,9.0,0,0,7.0,17,3.0,14.0,12.0,0.0,10.0,1,2,1.0,0,0.0,17.0,11.0,0.0,12.0,0,0,9.0,7,2.0,7.0,14.0,2.0,10.0,1,2,12.0,2,2.0,8.0,1.0,1.0,10.0,0,2,5.0,1,1.0,18.0,1.0,0.0,13.0,0,0,7.0,6,1.0,10.0,8.0,2.0,15.0,1,0,9.0,23,3.0,1.0,5.0,3.0,6.0,7.0,7.0,8.0,8.0,9.0,10.0,10.0,10.0,9.0,13.0,-4.0
985.0,2017,Manchester United Football Club,2.0,4.0,1.0,1,1,1.0,9,0.0,20.0,1.0,4.0,1.0,0,1,1.0,9,0.0,15.0,9.0,2.0,1.0,1,1,1.0,7,0.0,15.0,1.0,2.0,1.0,0,2,1.0,2,2.0,12.0,22.0,4.0,2.0,1,1,1.0,9,0.0,18.0,14.0,1.0,2.0,0,1,1.0,6,0.0,11.0,1.0,4.0,2.0,1,1,1.0,9,0.0,20.0,7.0,0.0,2.0,0,2,1.0,0,0.0,8.0,1.0,1.0,2.0,0,0,1.0,16,2.0,11.0,7.0,1.0,2.0,1,1,25.0,6,0.0,3.0,14.0,3.0,6.0,9.0,10.0,13.0,16.0,19.0,20.0,20.0,23.0,23.0,4.0,19.0
512.0,2017,Stoke City,19.0,0.0,16.0,0,0,22.0,6,1.0,7.0,14.0,1.0,14.0,1,1,22.0,6,0.0,12.0,22.0,1.0,11.0,0,2,11.0,1,1.0,5.0,7.0,2.0,12.0,1,2,22.0,2,2.0,1.0,1.0,1.0,13.0,0,0,22.0,16,2.0,4.0,1.0,0.0,16.0,1,0,22.0,9,4.0,3.0,22.0,2.0,13.0,1,1,22.0,16,1.0,12.0,1.0,2.0,17.0,0,0,10.0,27,7.0,1.0,5.0,1.0,17.0,1,0,11.0,16,2.0,19.0,3.0,1.0,14.0,0,1,22.0,6,0.0,8.0,5.0,0.0,3.0,4.0,5.0,5.0,5.0,8.0,8.0,8.0,11.0,11.0,20.0,-9.0
2288.0,2017,Swansea City,18.0,0.0,12.0,0,2,5.0,0,0.0,11.0,1.0,0.0,15.0,1,0,9.0,9,4.0,1.0,1.0,2.0,13.0,0,1,9.0,7,0.0,19.0,9.0,0.0,15.0,1,0,10.0,6,1.0,10.0,1.0,0.0,14.0,0,2,9.0,0,0.0,5.0,14.0,1.0,15.0,1,0,9.0,16,2.0,6.0,1.0,0.0,18.0,0,0,10.0,6,1.0,15.0,3.0,2.0,13.0,1,1,7.0,7,0.0,12.0,1.0,1.0,15.0,1,0,7.0,16,2.0,14.0,3.0,1.0,17.0,0,0,9.0,16,2.0,5.0,14.0,1.0,1.0,4.0,4.0,5.0,5.0,5.0,8.0,8.0,8.0,7.0,12.0,-5.0
379.0,2017,West Ham United Football Club,13.0,0.0,20.0,0,0,1.0,9,4.0,1.0,1.0,2.0,20.0,0,0,4.0,23,3.0,7.0,4.0,0.0,20.0,0,0,1.0,8,3.0,14.0,1.0,2.0,18.0,1,1,14.0,7,0.0,6.0,1.0,0.0,17.0,0,2,11.0,0,0.0,10.0,1.0,2.0,18.0,1,0,11.0,23,3.0,4.0,14.0,1.0,15.0,1,1,3.0,6,0.0,18.0,10.0,1.0,15.0,0,2,10.0,1,1.0,7.0,1.0,0.0,16.0,1,0,1.0,8,3.0,12.0,3.0,2.0,16.0,0,2,9.0,2,2.0,20.0,13.0,0.0,0.0,0.0,3.0,4.0,4.0,7.0,8.0,8.0,9.0,10.0,19.0,-9.0
989.0,2017,Association Football Club Bournemouth,12.0,0.0,15.0,0,0,12.0,6,1.0,8.0,7.0,0.0,16.0,1,0,1.0,7,2.0,4.0,5.0,1.0,18.0,1,0,17.0,16,2.0,4.0,5.0,0.0,19.0,0,0,14.0,8,3.0,11.0,14.0,2.0,19.0,1,1,3.0,16,1.0,16.0,13.0,1.0,19.0,0,0,3.0,16,2.0,14.0,1.0,0.0,19.0,1,2,12.0,0,0.0,17.0,12.0,0.0,19.0,0,0,17.0,6,1.0,3.0,1.0,2.0,19.0,0,1,3.0,16,1.0,17.0,11.0,0.0,19.0,1,0,13.0,6,1.0,4.0,14.0,0.0,0.0,0.0,0.0,3.0,3.0,4.0,4.0,7.0,7.0,6.0,14.0,-8.0
148.0,2017,Tottenham Hotspur Football Club,3.0,2.0,3.0,0,1,1.0,7,0.0,17.0,1.0,1.0,10.0,1,0,2.0,16,2.0,11.0,9.0,1.0,9.0,1,2,1.0,1,1.0,10.0,7.0,3.0,5.0,0,1,23.0,8,0.0,16.0,1.0,0.0,5.0,1,2,14.0,0,0.0,14.0,9.0,3.0,4.0,0,1,14.0,23,2.0,18.0,11.0,4.0,3.0,0,1,14.0,9,0.0,11.0,7.0,1.0,3.0,1,1,1.0,6,0.0,19.0,17.0,4.0,3.0,1,1,9.0,18,1.0,9.0,5.0,0.0,3.0,0,0,14.0,6,1.0,2.0,25.0,3.0,3.0,4.0,7.0,8.0,11.0,14.0,17.0,20.0,20.0,19.0,7.0,12.0
11.0,2017,Arsenal Football Club,6.0,4.0,5.0,1,1,14.0,29,3.0,13.0,12.0,0.0,12.0,0,0,22.0,6,1.0,14.0,22.0,0.0,16.0,0,0,14.0,9,4.0,2.0,5.0,3.0,11.0,1,1,14.0,8,0.0,19.0,14.0,0.0,12.0,0,2,22.0,0,0.0,3.0,22.0,2.0,7.0,1,1,14.0,7,0.0,12.0,9.0,2.0,5.0,1,1,14.0,7,0.0,14.0,7.0,1.0,6.0,0,0,14.0,16,2.0,4.0,11.0,5.0,5.0,0,1,14.0,25,2.0,18.0,18.0,2.0,5.0,1,1,14.0,16,1.0,17.0,9.0,3.0,3.0,3.0,6.0,7.0,10.0,13.0,13.0,16.0,19.0,19.0,13.0,6.0
873.0,2017,Crystal Palace Football Club,11.0,0.0,19.0,1,0,14.0,8,3.0,2.0,1.0,0.0,18.0,0,0,11.0,6,1.0,6.0,1.0,0.0,19.0,1,0,9.0,7,2.0,13.0,9.0,0.0,20.0,0,0,7.0,6,1.0,7.0,13.0,0.0,20.0,1,0,1.0,6,1.0,9.0,1.0,0.0,20.0,0,0,1.0,10,5.0,1.0,5.0,0.0,20.0,0,0,7.0,9,4.0,2.0,1.0,2.0,20.0,1,1,13.0,16,1.0,5.0,14.0,0.0,20.0,0,0,13.0,6,1.0,7.0,1.0,2.0,20.0,1,2,13.0,2,2.0,16.0,9.0,0.0,0.0,0.0,0.0,0.0,0.0,0.0,3.0,3.0,4.0,4.0,21.0,-17.0
1010.0,2017,Watford FC,14.0,3.0,10.0,1,2,5.0,3,3.0,9.0,5.0,2.0,4.0,0,1,5.0,7,0.0,16.0,1.0,0.0,7.0,1,2,5.0,0,0.0,17.0,12.0,2.0,4.0,0,1,7.0,7,0.0,13.0,1.0,0.0,11.0,1,0,5.0,11,6.0,1.0,5.0,2.0,6.0,0,1,1.0,16,1.0,15.0,9.0,2.0,8.0,0,2,1.0,2,2.0,10.0,12.0,2.0,4.0,1,1,11.0,16,1.0,6.0,14.0,2.0,6.0,0,0,11.0,24,4.0,4.0,11.0,0.0,8.0,1,0,5.0,6,1.0,14.0,22.0,1.0,4.0,5.0,8.0,8.0,11.0,12.0,15.0,15.0,15.0,15.0,18.0,-3.0
1003.0,2017,Leicester City Football Club,9.0,3.0,13.0,0,0,12.0,29,4.0,5.0,14.0,2.0,9.0,1,1,12.0,7,0.0,19.0,12.0,0.0,15.0,0,0,1.0,7,2.0,1.0,1.0,1.0,17.0,1,0,3.0,16,2.0,3.0,14.0,1.0,15.0,0,2,12.0,1,1.0,6.0,7.0,2.0,17.0,1,0,12.0,23,3.0,5.0,5.0,0.0,17.0,0,2,12.0,0,0.0,19.0,12.0,1.0,18.0,1,2,1.0,1,1.0,10.0,5.0,2.0,14.0,0,1,3.0,16,1.0,15.0,7.0,2.0,11.0,1,1,1.0,7,0.0,18.0,1.0,0.0,3.0,3.0,3.0,4.0,4.0,5.0,6.0,9.0,12.0,14.0,14.0,0.0
1132.0,2017,Burnley FC,7.0,3.0,6.0,0,1,6.0,23,2.0,14.0,14.0,0.0,13.0,1,0,7.0,6,1.0,3.0,7.0,1.0,10.0,0,2,7.0,1,1.0,9.0,1.0,1.0,7.0,1,1,13.0,6,0.0,20.0,7.0,1.0,7.0,0,2,12.0,1,1.0,8.0,7.0,0.0,9.0,1,2,6.0,0,0.0,8.0,7.0,1.0,6.0,0,1,1.0,6,0.0,16.0,3.0,1.0,7.0,1,2,1.0,1,1.0,15.0,10.0,0.0,8.0,0,0,7.0,8,3.0,1.0,7.0,1.0,7.0,1,1,12.0,6,0.0,9.0,12.0,3.0,3.0,4.0,7.0,8.0,9.0,12.0,13.0,13.0,16.0,9.0,9.0,0.0
762.0,2017,Newcastle United Football Club,10.0,0.0,17.0,1,0,1.0,7,2.0,3.0,1.0,0.0,17.0,0,0,1.0,6,1.0,2.0,7.0,3.0,14.0,1,1,1.0,8,0.0,20.0,1.0,1.0,10.0,0,1,1.0,6,0.0,15.0,10.0,2.0,4.0,1,1,1.0,16,1.0,13.0,22.0,0.0,10.0,0,0,1.0,6,1.0,13.0,13.0,1.0,9.0,1,2,1.0,1,1.0,7.0,7.0,2.0,9.0,0,2,1.0,2,2.0,11.0,3.0,1.0,7.0,1,1,1.0,6,0.0,20.0,13.0,0.0,9.0,0,0,12.0,6,1.0,7.0,12.0,0.0,0.0,3.0,6.0,9.0,9.0,10.0,11.0,14.0,14.0,10.0,9.0,1.0
29.0,2017,Everton Football Club,8.0,1.0,7.0,1,1,14.0,6,0.0,16.0,22.0,1.0,8.0,0,2,18.0,1,1.0,5.0,9.0,0.0,12.0,0,0,14.0,7,2.0,6.0,14.0,0.0,16.0,1,0,1.0,8,3.0,5.0,23.0,0.0,18.0,0,0,14.0,9,4.0,2.0,1.0,2.0,14.0,1,1,1.0,16,1.0,19.0,3.0,0.0,16.0,1,0,3.0,6,1.0,6.0,1.0,1.0,16.0,0,2,1.0,1,1.0,14.0,12.0,2.0,18.0,1,0,18.0,25,5.0,5.0,14.0,0.0,18.0,0,0,1.0,7,2.0,11.0,1.0,3.0,4.0,4.0,4.0,4.0,7.0,7.0,8.0,8.0,8.0,7.0,20.0,-13.0
1110.0,2018,Huddersfield Town,20.0,0.0,19.0,1,0,9.0,8,3.0,2.0,5.0,1.0,20.0,0,0,3.0,20,6.0,1.0,5.0,0.0,19.0,1,2,1.0,0,0.0,15.0,5.0,1.0,17.0,0,2,11.0,1,1.0,7.0,1.0,0.0,18.0,1,0,11.0,6,1.0,12.0,5.0,1.0,19.0,0,0,11.0,17,3.0,9.0,1.0,0.0,20.0,1,0,9.0,7,2.0,4.0,14.0,1.0,18.0,0,2,1.0,1,1.0,12.0,1.0,0.0,19.0,1,0,9.0,6,1.0,2.0,5.0,0.0,20.0,0,0,1.0,8,3.0,7.0,3.0,0.0,0.0,1.0,2.0,2.0,2.0,2.0,3.0,3.0,3.0,4.0,21.0,-17.0
603.0,2018,Cardiff City,18.0,0.0,17.0,0,0,7.0,7,2.0,5.0,3.0,0.0,16.0,1,2,7.0,0,0.0,12.0,12.0,0.0,15.0,0,2,5.0,0,0.0,19.0,1.0,2.0,16.0,1,0,13.0,23,3.0,9.0,1.0,1.0,17.0,0,0,1.0,18,4.0,1.0,5.0,0.0,20.0,1,0,13.0,10,5.0,2.0,5.0,1.0,19.0,1,0,12.0,16,2.0,12.0,12.0,0.0,20.0,0,0,7.0,6,1.0,5.0,3.0,4.0,17.0,1,1,3.0,24,2.0,18.0,5.0,1.0,17.0,0,0,1.0,18,4.0,2.0,1.0,0.0,1.0,2.0,2.0,2.0,2.0,2.0,2.0,5.0,5.0,9.0,23.0,-14.0
631.0,2018,Chelsea Football Club,3.0,3.0,2.0,0,1,5.0,8,0.0,19.0,9.0,3.0,3.0,1,1,5.0,23,2.0,17.0,1.0,2.0,3.0,0,1,5.0,16,1.0,16.0,11.0,2.0,2.0,1,1,5.0,7,0.0,6.0,11.0,4.0,1.0,1,1,5.0,18,1.0,17.0,1.0,0.0,3.0,0,2,5.0,0,0.0,17.0,7.0,1.0,3.0,1,2,5.0,1,1.0,2.0,5.0,3.0,2.0,0,1,5.0,8,0.0,16.0,11.0,2.0,3.0,1,2,5.0,2,2.0,10.0,5.0,4.0,3.0,0,1,5.0,9,0.0,15.0,1.0,3.0,6.0,9.0,12.0,15.0,16.0,17.0,20.0,21.0,24.0,24.0,7.0,17.0
1010.0,2018,Watford FC,11.0,2.0,6.0,1,1,3.0,7,0.0,16.0,12.0,3.0,4.0,0,1,13.0,17,1.0,15.0,1.0,2.0,4.0,1,1,3.0,16,1.0,10.0,3.0,2.0,3.0,1,1,13.0,16,1.0,5.0,9.0,1.0,4.0,1,0,13.0,16,2.0,8.0,1.0,1.0,4.0,0,2,16.0,1,1.0,15.0,5.0,0.0,6.0,0,0,3.0,7,2.0,5.0,1.0,0.0,9.0,1,0,3.0,9,4.0,6.0,3.0,2.0,7.0,0,1,3.0,7,0.0,9.0,11.0,3.0,7.0,1,1,3.0,8,0.0,20.0,1.0,3.0,6.0,9.0,12.0,12.0,13.0,13.0,13.0,16.0,19.0,16.0,12.0,4.0
180.0,2018,Southampton Football Club,16.0,0.0,12.0,1,2,14.0,0,0.0,11.0,1.0,1.0,13.0,0,0,3.0,16,2.0,7.0,1.0,1.0,17.0,1,0,3.0,16,2.0,7.0,1.0,2.0,12.0,0,1,3.0,7,0.0,15.0,3.0,2.0,13.0,1,2,3.0,2,2.0,14.0,7.0,0.0,14.0,0,0,7.0,8,3.0,1.0,1.0,0.0,16.0,0,0,3.0,7,2.0,9.0,11.0,0.0,16.0,1,0,11.0,8,3.0,2.0,5.0,0.0,16.0,0,2,3.0,0,0.0,6.0,3.0,0.0,16.0,1,2,3.0,0,0.0,19.0,3.0,1.0,1.0,1.0,4.0,5.0,5.0,5.0,5.0,6.0,7.0,6.0,14.0,-8.0
985.0,2018,Manchester United Football Club,6.0,2.0,7.0,1,1,7.0,16,1.0,13.0,3.0,2.0,9.0,0,0,5.0,23,3.0,11.0,12.0,0.0,13.0,1,0,9.0,8,3.0,2.0,8.0,2.0,10.0,0,1,5.0,7,0.0,19.0,12.0,2.0,8.0,0,1,1.0,16,1.0,4.0,13.0,1.0,7.0,1,2,5.0,1,1.0,10.0,11.0,1.0,10.0,0,0,9.0,17,3.0,14.0,7.0,3.0,8.0,1,1,4.0,23,2.0,19.0,12.0,2.0,10.0,0,2,5.0,2,2.0,3.0,5.0,2.0,8.0,1,1,1.0,16,1.0,9.0,1.0,3.0,3.0,3.0,6.0,9.0,10.0,10.0,13.0,14.0,17.0,17.0,17.0,0.0
543.0,2018,Wolverhampton Wanderers Football Club,7.0,2.0,10.0,1,2,22.0,2,2.0,9.0,1.0,0.0,14.0,0,0,22.0,7,2.0,8.0,1.0,1.0,14.0,1,2,11.0,1,1.0,5.0,5.0,1.0,11.0,0,1,11.0,6,0.0,20.0,1.0,1.0,9.0,1,1,11.0,6,0.0,20.0,3.0,1.0,10.0,0,2,11.0,1,1.0,7.0,5.0,2.0,9.0,1,1,11.0,7,0.0,16.0,3.0,1.0,7.0,0,1,11.0,6,0.0,14.0,13.0,0.0,9.0,1,0,11.0,7,2.0,7.0,3.0,0.0,10.0,0,0,11.0,6,1.0,11.0,3.0,1.0,1.0,2.0,5.0,8.0,9.0,12.0,15.0,15.0,15.0,9.0,9.0,0.0
873.0,2018,Crystal Palace Football Club,12.0,2.0,4.0,0,1,13.0,7,0.0,18.0,5.0,0.0,10.0,1,0,13.0,7,2.0,2.0,5.0,1.0,10.0,0,0,3.0,16,2.0,4.0,3.0,0.0,15.0,1,0,3.0,7,2.0,12.0,3.0,1.0,12.0,0,1,5.0,6,0.0,18.0,11.0,0.0,11.0,1,2,5.0,0,0.0,18.0,12.0,1.0,13.0,0,0,7.0,16,2.0,7.0,3.0,0.0,14.0,1,0,13.0,6,1.0,7.0,11.0,0.0,15.0,0,0,3.0,7,2.0,8.0,1.0,2.0,14.0,1,2,5.0,2,2.0,4.0,1.0,3.0,3.0,3.0,3.0,6.0,7.0,7.0,7.0,7.0,8.0,7.0,13.0,-6.0
379.0,2018,West Ham United Football Club,10.0,0.0,20.0,0,0,1.0,9,4.0,1.0,5.0,1.0,19.0,1,0,3.0,16,2.0,6.0,3.0,1.0,20.0,0,0,1.0,17,3.0,9.0,1.0,0.0,20.0,1,0,1.0,6,1.0,11.0,11.0,3.0,16.0,0,1,5.0,17,1.0,10.0,1.0,0.0,17.0,1,2,7.0,0,0.0,3.0,5.0,3.0,14.0,1,1,7.0,17,1.0,10.0,9.0,0.0,15.0,0,0,5.0,6,1.0,13.0,1.0,0.0,14.0,1,0,7.0,6,1.0,5.0,2.0,1.0,13.0,0,2,7.0,1,1.0,12.0,1.0,0.0,0.0,0.0,0.0,3.0,4.0,7.0,7.0,7.0,8.0,9.0,15.0,-6.0
1237.0,2018,Brighton and Hove Albion Football Club,17.0,0.0,16.0,0,0,12.0,7,2.0,6.0,3.0,3.0,11.0,1,1,12.0,23,2.0,9.0,5.0,0.0,12.0,0,0,7.0,6,1.0,1.0,5.0,2.0,14.0,1,2,12.0,2,2.0,13.0,5.0,2.0,14.0,0,2,7.0,2,2.0,13.0,3.0,1.0,13.0,1,0,7.0,16,2.0,5.0,1.0,0.0,15.0,0,0,7.0,7,2.0,1.0,5.0,1.0,13.0,1,1,1.0,6,0.0,15.0,5.0,1.0,12.0,0,1,3.0,6,0.0,20.0,3.0,1.0,11.0,1,1,3.0,6,0.0,10.0,11.0,0.0,3.0,3.0,4.0,5.0,5.0,5.0,8.0,11.0,14.0,11.0,13.0,-2.0
148.0,2018,Tottenham Hotspur Football Club,4.0,2.0,8.0,0,1,2.0,16,1.0,14.0,12.0,3.0,5.0,1,1,9.0,17,1.0,18.0,5.0,3.0,2.0,0,1,8.0,8,0.0,13.0,9.0,1.0,5.0,0,0,9.0,16,2.0,3.0,13.0,1.0,6.0,1,0,8.0,16,2.0,2.0,5.0,2.0,5.0,0,1,1.0,16,1.0,13.0,7.0,2.0,4.0,0,1,14.0,7,0.0,20.0,9.0,1.0,5.0,1,1,3.0,6,0.0,20.0,7.0,1.0,5.0,0,1,2.0,6,0.0,14.0,7.0,0.0,5.0,1,0,3.0,6,1.0,1.0,5.0,3.0,6.0,9.0,9.0,9.0,12.0,15.0,18.0,21.0,21.0,16.0,8.0,8.0
762.0,2018,Newcastle United Football Club,13.0,1.0,14.0,1,0,12.0,16,2.0,8.0,2.0,0.0,12.0,0,2,12.0,0,0.0,16.0,7.0,1.0,16.0,1,0,11.0,16,2.0,3.0,5.0,1.0,18.0,0,0,11.0,16,2.0,4.0,3.0,1.0,19.0,1,0,3.0,16,2.0,7.0,1.0,0.0,18.0,0,2,12.0,0,0.0,11.0,5.0,0.0,18.0,1,0,1.0,7,2.0,8.0,1.0,2.0,19.0,0,0,12.0,23,3.0,8.0,4.0,0.0,20.0,1,0,3.0,6,1.0,12.0,3.0,0.0,19.0,0,2,3.0,0,0.0,16.0,3.0,0.0,1.0,1.0,1.0,1.0,2.0,2.0,2.0,2.0,3.0,6.0,14.0,-8.0
281.0,2018,Manchester City Football Club,1.0,2.0,3.0,0,1,1.0,7,0.0,15.0,1.0,6.0,1.0,1,1,5.0,20,1.0,20.0,3.0,1.0,5.0,0,2,5.0,1,1.0,14.0,11.0,2.0,4.0,1,1,3.0,16,1.0,18.0,11.0,3.0,3.0,1,1,5.0,8,0.0,15.0,5.0,5.0,2.0,0,1,5.0,10,0.0,20.0,13.0,2.0,1.0,1,1,5.0,7,0.0,15.0,7.0,0.0,1.0,0,2,1.0,0,0.0,3.0,5.0,5.0,1.0,1,1,5.0,10,0.0,13.0,1.0,1.0,1.0,0,1,5.0,6,0.0,5.0,3.0,3.0,6.0,7.0,10.0,13.0,16.0,19.0,20.0,23.0,26.0,27.0,3.0,24.0
989.0,2018,Association Football Club Bournemouth,14.0,2.0,5.0,1,1,3.0,7,0.0,17.0,7.0,2.0,6.0,0,1,3.0,16,1.0,19.0,3.0,2.0,6.0,1,2,3.0,2,2.0,8.0,1.0,0.0,6.0,0,0,11.0,7,2.0,2.0,5.0,4.0,5.0,1,1,3.0,24,2.0,11.0,1.0,0.0,8.0,0,0,3.0,9,4.0,16.0,3.0,2.0,7.0,1,1,3.0,16,1.0,13.0,7.0,4.0,6.0,0,1,3.0,9,0.0,9.0,3.0,0.0,6.0,1,2,3.0,0,0.0,16.0,3.0,3.0,6.0,0,1,11.0,8,0.0,18.0,1.0,3.0,6.0,7.0,7.0,10.0,10.0,13.0,16.0,17.0,20.0,19.0,12.0,7.0
1132.0,2018,Burnley FC,15.0,0.0,11.0,0,2,1.0,0,0.0,12.0,14.0,1.0,15.0,1,0,1.0,17,3.0,4.0,13.0,2.0,18.0,0,0,12.0,24,4.0,11.0,5.0,0.0,19.0,1,0,12.0,7,2.0,10.0,5.0,0.0,20.0,0,0,3.0,6,1.0,9.0,11.0,4.0,16.0,1,1,3.0,9,0.0,8.0,3.0,2.0,12.0,0,1,12.0,16,1.0,19.0,12.0,1.0,12.0,1,2,1.0,1,1.0,18.0,1.0,0.0,13.0,0,0,1.0,10,5.0,1.0,5.0,0.0,15.0,1,0,1.0,9,4.0,3.0,5.0,1.0,1.0,1.0,1.0,1.0,4.0,7.0,8.0,8.0,8.0,10.0,21.0,-11.0
29.0,2018,Everton Football Club,8.0,2.0,9.0,0,2,1.0,2,2.0,10.0,22.0,2.0,7.0,1,1,1.0,16,1.0,13.0,3.0,2.0,8.0,0,2,1.0,2,2.0,6.0,3.0,1.0,7.0,1,2,1.0,1,1.0,17.0,11.0,1.0,10.0,1,0,1.0,17,3.0,16.0,5.0,0.0,12.0,0,0,1.0,7,2.0,6.0,1.0,3.0,11.0,1,1,1.0,8,0.0,17.0,3.0,2.0,11.0,0,1,1.0,16,1.0,10.0,3.0,2.0,8.0,1,1,1.0,7,0.0,15.0,3.0,1.0,9.0,0,0,1.0,16,2.0,8.0,1.0,1.0,4.0,5.0,6.0,6.0,6.0,9.0,12.0,15.0,15.0,16.0,14.0,2.0
31.0,2018,Liverpool Football Club,2.0,4.0,1.0,1,1,5.0,9,0.0,20.0,1.0,2.0,2.0,0,1,5.0,7,0.0,10.0,13.0,1.0,1.0,1,1,5.0,6,0.0,12.0,7.0,2.0,1.0,0,1,5.0,16,1.0,8.0,1.0,2.0,2.0,0,1,5.0,16,1.0,6.0,8.0,3.0,1.0,1,1,1.0,8,0.0,14.0,7.0,1.0,2.0,0,2,5.0,1,1.0,3.0,5.0,0.0,3.0,1,2,5.0,0,0.0,1.0,1.0,1.0,2.0,0,1,5.0,6,0.0,19.0,9.0,4.0,2.0,1,1,1.0,18,1.0,17.0,1.0,3.0,6.0,9.0,12.0,15.0,18.0,19.0,20.0,23.0,26.0,20.0,4.0,16.0
11.0,2018,Arsenal Football Club,5.0,0.0,15.0,1,0,1.0,7,2.0,3.0,1.0,2.0,17.0,0,0,1.0,23,3.0,3.0,5.0,3.0,9.0,1,1,1.0,17,1.0,20.0,1.0,3.0,9.0,0,1,1.0,23,2.0,16.0,13.0,2.0,7.0,0,1,1.0,16,1.0,19.0,3.0,2.0,6.0,1,1,1.0,7,0.0,12.0,1.0,2.0,5.0,1,1,1.0,7,0.0,6.0,3.0,5.0,4.0,0,1,3.0,19,1.0,17.0,11.0,3.0,4.0,1,1,1.0,17,1.0,11.0,17.0,2.0,4.0,0,2,1.0,2,2.0,14.0,5.0,0.0,0.0,3.0,6.0,9.0,12.0,15.0,18.0,21.0,22.0,24.0,13.0,11.0
1003.0,2018,Leicester City Football Club,9.0,1.0,13.0,0,0,3.0,16,2.0,7.0,7.0,2.0,8.0,1,1,1.0,7,0.0,14.0,22.0,2.0,7.0,0,1,1.0,16,1.0,17.0,3.0,1.0,8.0,1,0,1.0,16,2.0,1.0,5.0,2.0,11.0,0,0,1.0,24,4.0,5.0,3.0,3.0,9.0,1,1,1.0,17,1.0,19.0,11.0,2.0,8.0,0,1,1.0,7,0.0,18.0,1.0,1.0,10.0,1,0,3.0,16,2.0,11.0,1.0,1.0,11.0,0,0,17.0,17,3.0,4.0,1.0,1.0,12.0,1,2,1.0,1,1.0,13.0,7.0,0.0,3.0,6.0,6.0,6.0,9.0,12.0,12.0,12.0,13.0,16.0,16.0,0.0
931.0,2018,Fulham Football Club,19.0,0.0,18.0,1,0,5.0,7,2.0,4.0,13.0,1.0,18.0,0,0,5.0,17,3.0,5.0,9.0,4.0,11.0,1,1,5.0,24,2.0,18.0,12.0,2.0,13.0,0,2,5.0,2,2.0,14.0,12.0,0.0,15.0,0,0,5.0,8,3.0,3.0,5.0,1.0,15.0,1,2,5.0,1,1.0,4.0,16.0,0.0,17.0,0,0,3.0,8,3.0,11.0,1.0,1.0,17.0,1,0,11.0,19,5.0,4.0,3.0,2.0,18.0,0,0,5.0,24,4.0,17.0,3.0,0.0,18.0,1,0,1.0,8,3.0,6.0,11.0,0.0,0.0,3.0,4.0,4.0,5.0,5.0,5.0,5.0,5.0,11.0,28.0,-17.0
1237.0,2021,Brighton and Hove Albion Football Club,9.0,2.0,8.0,0,1,14.0,16,1.0,12.0,3.0,2.0,4.0,1,1,14.0,7,0.0,11.0,5.0,0.0,8.0,1,0,9.0,7,2.0,6.0,3.0,1.0,6.0,0,1,22.0,6,0.0,10.0,9.0,2.0,4.0,1,1,14.0,16,1.0,12.0,7.0,1.0,6.0,0,2,11.0,1,1.0,15.0,5.0,0.0,6.0,1,2,9.0,0,0.0,11.0,1.0,0.0,4.0,0,2,9.0,0,0.0,20.0,9.0,1.0,5.0,1,0,9.0,18,4.0,3.0,5.0,2.0,8.0,0,2,1.0,2,2.0,2.0,5.0,3.0,6.0,6.0,9.0,12.0,13.0,14.0,15.0,15.0,16.0,11.0,11.0,0.0
31.0,2021,Liverpool Football Club,2.0,3.0,3.0,0,1,5.0,8,0.0,19.0,5.0,2.0,3.0,1,1,5.0,7,0.0,17.0,3.0,1.0,5.0,1,2,5.0,1,1.0,4.0,14.0,3.0,3.0,0,1,5.0,8,0.0,17.0,7.0,3.0,2.0,1,1,5.0,8,0.0,14.0,5.0,3.0,1.0,0,2,5.0,3,3.0,9.0,9.0,2.0,2.0,1,2,5.0,2,2.0,3.0,5.0,5.0,2.0,0,1,5.0,10,0.0,16.0,11.0,5.0,2.0,0,1,5.0,10,0.0,7.0,1.0,2.0,2.0,1,2,5.0,2,2.0,8.0,1.0,3.0,6.0,7.0,10.0,13.0,14.0,15.0,18.0,21.0,22.0,29.0,8.0,21.0
379.0,2021,West Ham United Football Club,7.0,4.0,4.0,0,1,1.0,24,2.0,15.0,9.0,4.0,1.0,1,1,1.0,18,1.0,12.0,1.0,2.0,2.0,1,2,1.0,2,2.0,14.0,5.0,0.0,8.0,0,2,1.0,0,0.0,14.0,3.0,1.0,8.0,1,0,1.0,16,2.0,3.0,1.0,2.0,7.0,0,1,1.0,16,1.0,18.0,7.0,1.0,9.0,1,0,1.0,16,2.0,7.0,9.0,1.0,7.0,0,1,1.0,6,0.0,8.0,1.0,1.0,4.0,1,1,1.0,6,0.0,6.0,1.0,4.0,4.0,0,1,1.0,18,1.0,15.0,7.0,3.0,6.0,7.0,8.0,8.0,11.0,11.0,14.0,17.0,20.0,20.0,11.0,9.0
148.0,2021,Tottenham Hotspur Football Club,4.0,1.0,9.0,1,1,5.0,6,0.0,14.0,5.0,1.0,5.0,0,1,5.0,6,0.0,16.0,11.0,1.0,1.0,1,1,5.0,6,0.0,12.0,5.0,0.0,7.0,0,0,2.0,8,3.0,11.0,7.0,0.0,7.0,1,0,8.0,8,3.0,1.0,14.0,1.0,11.0,0,0,5.0,17,3.0,10.0,1.0,2.0,8.0,1,1,1.0,16,1.0,10.0,9.0,3.0,5.0,0,1,1.0,23,2.0,19.0,7.0,0.0,6.0,0,0,1.0,6,1.0,4.0,1.0,0.0,9.0,1,0,1.0,8,3.0,5.0,9.0,3.0,6.0,9.0,9.0,9.0,9.0,12.0,15.0,15.0,15.0,9.0,16.0,-7.0
180.0,2021,Southampton Football Club,15.0,1.0,16.0,0,0,3.0,17,3.0,5.0,1.0,1.0,13.0,1,2,3.0,1,1.0,6.0,1.0,2.0,13.0,0,2,3.0,2,2.0,17.0,9.0,0.0,14.0,1,2,3.0,0,0.0,8.0,1.0,0.0,15.0,0,2,3.0,0,0.0,5.0,5.0,0.0,16.0,1,0,3.0,6,1.0,14.0,11.0,1.0,17.0,0,0,3.0,17,3.0,1.0,22.0,1.0,15.0,1,1,3.0,6,0.0,17.0,23.0,2.0,16.0,1,2,3.0,2,2.0,18.0,1.0,1.0,14.0,0,1,3.0,6,0.0,16.0,1.0,0.0,1.0,2.0,3.0,4.0,4.0,4.0,7.0,8.0,11.0,9.0,12.0,-3.0
281.0,2021,Manchester City Football Club,1.0,0.0,14.0,0,0,5.0,6,1.0,9.0,5.0,5.0,9.0,1,1,5.0,10,0.0,20.0,5.0,5.0,7.0,1,1,5.0,10,0.0,20.0,11.0,1.0,5.0,0,1,5.0,6,0.0,9.0,1.0,0.0,5.0,1,2,5.0,0,0.0,15.0,3.0,1.0,2.0,0,1,5.0,6,0.0,3.0,9.0,2.0,3.0,0,2,5.0,2,2.0,2.0,5.0,2.0,3.0,1,1,5.0,7,0.0,18.0,1.0,4.0,3.0,0,1,5.0,18,1.0,5.0,9.0,0.0,3.0,1,0,5.0,7,2.0,13.0,5.0,0.0,3.0,6.0,9.0,10.0,13.0,14.0,17.0,20.0,20.0,20.0,6.0,14.0
11.0,2021,Arsenal Football Club,5.0,0.0,17.0,0,0,1.0,7,2.0,6.0,9.0,0.0,19.0,1,0,1.0,7,2.0,2.0,14.0,0.0,20.0,0,0,11.0,10,5.0,7.0,5.0,1.0,16.0,1,1,1.0,6,0.0,20.0,1.0,1.0,13.0,0,1,7.0,6,0.0,19.0,3.0,3.0,10.0,1,1,1.0,17,1.0,11.0,5.0,0.0,11.0,0,2,1.0,0,0.0,6.0,9.0,2.0,12.0,1,2,7.0,2,2.0,14.0,1.0,3.0,10.0,1,1,3.0,17,1.0,13.0,17.0,2.0,6.0,0,1,3.0,7,0.0,11.0,17.0,0.0,0.0,0.0,3.0,6.0,9.0,10.0,11.0,14.0,17.0,12.0,13.0,-1.0
1003.0,2021,Leicester City Football Club,8.0,1.0,10.0,1,1,1.0,6,0.0,13.0,11.0,1.0,12.0,0,0,1.0,18,4.0,1.0,1.0,2.0,9.0,0,1,12.0,16,1.0,19.0,7.0,0.0,9.0,1,0,1.0,6,1.0,5.0,5.0,1.0,12.0,0,0,7.0,16,2.0,4.0,14.0,2.0,13.0,1,2,7.0,2,2.0,19.0,3.0,2.0,13.0,0,2,3.0,2,2.0,14.0,7.0,4.0,11.0,1,1,18.0,24,2.0,6.0,1.0,2.0,9.0,0,1,25.0,16,1.0,12.0,9.0,0.0,11.0,1,0,17.0,7,2.0,6.0,3.0,3.0,3.0,6.0,6.0,6.0,7.0,8.0,11.0,14.0,14.0,15.0,17.0,-2.0
1010.0,2021,Watford FC,19.0,3.0,7.0,1,1,7.0,23,2.0,11.0,1.0,0.0,11.0,0,0,5.0,7,2.0,4.0,14.0,0.0,12.0,0,0,5.0,6,1.0,1.0,5.0,0.0,15.0,1,0,5.0,7,2.0,13.0,11.0,3.0,11.0,0,1,1.0,17,1.0,20.0,5.0,1.0,12.0,1,2,1.0,1,1.0,17.0,1.0,0.0,15.0,0,0,1.0,6,1.0,16.0,7.0,0.0,16.0,1,0,11.0,10,5.0,2.0,5.0,5.0,14.0,0,1,1.0,25,2.0,8.0,1.0,0.0,16.0,1,0,1.0,6,1.0,14.0,3.0,3.0,3.0,3.0,3.0,6.0,7.0,7.0,7.0,10.0,10.0,12.0,18.0,-6.0
543.0,2021,Wolverhampton Wanderers Football Club,10.0,0.0,13.0,0,0,11.0,6,1.0,10.0,1.0,0.0,16.0,1,0,11.0,6,1.0,5.0,5.0,0.0,18.0,1,0,11.0,6,1.0,3.0,1.0,2.0,13.0,0,1,11.0,7,0.0,15.0,5.0,0.0,16.0,1,0,22.0,7,2.0,9.0,9.0,1.0,14.0,0,1,11.0,6,0.0,16.0,3.0,2.0,12.0,1,1,11.0,16,1.0,19.0,5.0,3.0,10.0,0,1,14.0,23,2.0,13.0,18.0,1.0,11.0,0,2,11.0,1,1.0,17.0,3.0,2.0,7.0,1,1,11.0,16,1.0,10.0,1.0,0.0,0.0,0.0,3.0,3.0,6.0,9.0,12.0,13.0,16.0,11.0,10.0,1.0
985.0,2021,Manchester United Football Club,6.0,5.0,1.0,1,1,1.0,19,1.0,20.0,7.0,1.0,6.0,0,2,1.0,1,1.0,13.0,3.0,1.0,3.0,0,1,1.0,6,0.0,18.0,11.0,4.0,1.0,1,1,1.0,18,1.0,19.0,11.0,2.0,3.0,0,1,1.0,16,1.0,8.0,1.0,0.0,4.0,1,0,1.0,6,1.0,8.0,9.0,1.0,4.0,1,2,1.0,1,1.0,5.0,1.0,2.0,6.0,0,0,1.0,24,4.0,11.0,18.0,0.0,7.0,1,0,1.0,10,5.0,2.0,5.0,3.0,5.0,0,1,9.0,8,0.0,9.0,1.0,3.0,4.0,7.0,10.0,13.0,13.0,14.0,14.0,14.0,17.0,19.0,15.0,4.0
1148.0,2021,Brentford Football Club,13.0,2.0,6.0,1,1,9.0,7,0.0,17.0,1.0,0.0,8.0,0,2,9.0,0,0.0,14.0,5.0,1.0,10.0,0,2,25.0,1,1.0,11.0,5.0,0.0,10.0,1,0,9.0,6,1.0,6.0,22.0,2.0,9.0,0,1,9.0,7,0.0,16.0,22.0,3.0,9.0,1,2,9.0,3,3.0,1.0,5.0,2.0,7.0,0,1,9.0,16,1.0,9.0,1.0,0.0,9.0,1,0,9.0,6,1.0,1.0,9.0,1.0,12.0,1,0,9.0,16,2.0,9.0,25.0,1.0,12.0,0,0,9.0,17,3.0,18.0,3.0,3.0,4.0,5.0,5.0,8.0,9.0,12.0,12.0,12.0,12.0,12.0,12.0,0.0
873.0,2021,Crystal Palace Football Club,12.0,0.0,18.0,0,0,3.0,8,3.0,2.0,14.0,0.0,14.0,1,2,5.0,0,0.0,8.0,9.0,2.0,14.0,0,2,5.0,2,2.0,2.0,1.0,3.0,11.0,1,1,7.0,8,0.0,7.0,2.0,0.0,14.0,0,0,5.0,8,3.0,2.0,5.0,1.0,15.0,1,2,5.0,1,1.0,6.0,11.0,2.0,14.0,1,2,7.0,2,2.0,13.0,3.0,2.0,14.0,0,2,1.0,2,2.0,12.0,7.0,1.0,15.0,1,2,5.0,1,1.0,19.0,9.0,2.0,13.0,0,1,5.0,7,0.0,3.0,5.0,0.0,1.0,2.0,5.0,5.0,6.0,7.0,8.0,9.0,12.0,13.0,14.0,-1.0
405.0,2021,Aston Villa Football Club,14.0,2.0,11.0,0,0,1.0,23,3.0,7.0,7.0,2.0,10.0,1,1,5.0,7,0.0,18.0,9.0,1.0,11.0,1,2,5.0,1,1.0,10.0,25.0,0.0,12.0,0,0,9.0,8,3.0,2.0,14.0,3.0,10.0,1,1,9.0,8,0.0,6.0,3.0,1.0,8.0,0,1,9.0,6,0.0,4.0,1.0,1.0,10.0,0,0,9.0,16,2.0,8.0,1.0,2.0,13.0,1,0,18.0,23,3.0,10.0,14.0,1.0,13.0,0,0,17.0,17,3.0,10.0,3.0,1.0,15.0,1,0,7.0,18,4.0,4.0,1.0,0.0,3.0,4.0,4.0,7.0,10.0,10.0,10.0,10.0,10.0,14.0,19.0,-5.0
762.0,2021,Newcastle United Football Club,11.0,2.0,15.0,1,0,9.0,24,4.0,4.0,1.0,0.0,18.0,0,0,9.0,7,2.0,10.0,5.0,2.0,17.0,1,2,9.0,2,2.0,13.0,3.0,1.0,19.0,0,0,11.0,18,4.0,1.0,1.0,1.0,18.0,1,2,11.0,1,1.0,17.0,7.0,1.0,17.0,0,2,1.0,1,1.0,12.0,1.0,1.0,19.0,0,0,5.0,16,2.0,12.0,11.0,2.0,19.0,1,0,7.0,23,3.0,5.0,1.0,1.0,19.0,0,2,9.0,1,1.0,15.0,5.0,0.0,19.0,1,0,17.0,8,3.0,1.0,14.0,0.0,0.0,1.0,1.0,2.0,3.0,3.0,3.0,4.0,4.0,11.0,23.0,-12.0
631.0,2021,Chelsea Football Club,3.0,3.0,2.0,1,1,14.0,8,0.0,18.0,3.0,2.0,2.0,0,1,14.0,7,0.0,19.0,1.0,1.0,4.0,0,2,14.0,1,1.0,5.0,5.0,3.0,2.0,1,1,14.0,8,0.0,12.0,9.0,3.0,1.0,0,1,14.0,8,0.0,7.0,8.0,0.0,3.0,1,0,9.0,6,1.0,2.0,5.0,3.0,1.0,1,1,22.0,17,1.0,17.0,3.0,1.0,1.0,0,1,9.0,6,0.0,9.0,9.0,7.0,1.0,1,1,14.0,12,0.0,20.0,9.0,3.0,1.0,0,1,14.0,8,0.0,19.0,17.0,3.0,6.0,7.0,10.0,13.0,13.0,16.0,19.0,22.0,25.0,26.0,3.0,23.0
29.0,2021,Everton Football Club,16.0,3.0,5.0,1,1,1.0,17,1.0,16.0,3.0,2.0,7.0,0,2,3.0,2,2.0,15.0,23.0,2.0,6.0,0,1,3.0,7,0.0,8.0,9.0,3.0,4.0,1,1,22.0,17,1.0,18.0,3.0,0.0,6.0,0,0,3.0,8,3.0,10.0,9.0,2.0,5.0,1,1,1.0,7,0.0,20.0,9.0,1.0,5.0,0,2,1.0,1,1.0,4.0,1.0,0.0,8.0,1,0,1.0,6,1.0,7.0,1.0,2.0,8.0,1,0,1.0,25,5.0,14.0,1.0,1.0,10.0,0,0,1.0,16,2.0,7.0,11.0,3.0,4.0,7.0,10.0,10.0,13.0,14.0,14.0,14.0,14.0,16.0,16.0,0.0
399.0,2021,Leeds United,17.0,1.0,20.0,0,0,7.0,19,5.0,1.0,1.0,2.0,15.0,1,2,23.0,2,2.0,7.0,3.0,1.0,15.0,0,2,23.0,1,1.0,16.0,3.0,0.0,17.0,1,0,7.0,8,3.0,3.0,5.0,1.0,17.0,0,2,7.0,1,1.0,18.0,11.0,1.0,18.0,1,0,7.0,16,2.0,7.0,1.0,1.0,16.0,1,1,7.0,6,0.0,15.0,1.0,0.0,17.0,0,0,23.0,6,1.0,15.0,3.0,1.0,17.0,1,2,3.0,1,1.0,11.0,11.0,2.0,17.0,0,1,29.0,16,1.0,20.0,25.0,0.0,1.0,2.0,2.0,3.0,3.0,6.0,6.0,7.0,10.0,10.0,17.0,-7.0
1132.0,2021,Burnley FC,18.0,1.0,12.0,1,0,3.0,16,2.0,8.0,14.0,0.0,17.0,0,0,3.0,7,2.0,3.0,5.0,1.0,16.0,1,2,3.0,1,1.0,15.0,23.0,1.0,18.0,0,0,3.0,17,3.0,4.0,22.0,0.0,19.0,1,0,3.0,6,1.0,13.0,7.0,2.0,19.0,0,2,3.0,2,2.0,13.0,7.0,0.0,18.0,1,2,3.0,0,0.0,20.0,9.0,0.0,18.0,0,0,1.0,7,2.0,3.0,5.0,2.0,18.0,0,2,1.0,2,2.0,16.0,3.0,3.0,18.0,1,1,3.0,17,1.0,12.0,9.0,0.0,0.0,1.0,1.0,1.0,2.0,3.0,3.0,4.0,7.0,10.0,16.0,-6.0
1123.0,2021,Norwich City,20.0,0.0,19.0,1,0,5.0,8,3.0,3.0,5.0,0.0,20.0,0,0,5.0,10,5.0,9.0,5.0,1.0,19.0,1,0,7.0,16,2.0,9.0,12.0,0.0,20.0,0,0,1.0,6,1.0,16.0,1.0,1.0,20.0,1,0,5.0,17,3.0,11.0,1.0,0.0,20.0,0,0,9.0,7,2.0,5.0,1.0,0.0,20.0,0,2,9.0,0,0.0,18.0,3.0,0.0,20.0,1,2,9.0,0,0.0,4.0,9.0,0.0,20.0,0,0,9.0,12,7.0,1.0,14.0,1.0,20.0,1,0,25.0,16,2.0,17.0,29.0,0.0,0.0,0.0,0.0,0.0,0.0,1.0,2.0,2.0,2.0,3.0,25.0,-22.0
931.0,2022,Fulham Football Club,10.0,2.0,9.0,1,2,1.0,2,2.0,10.0,5.0,0.0,13.0,0,2,1.0,0,0.0,14.0,1.0,3.0,7.0,1,1,1.0,23,2.0,8.0,5.0,1.0,11.0,0,0,1.0,16,2.0,1.0,1.0,2.0,8.0,1,1,1.0,16,1.0,4.0,7.0,1.0,10.0,0,0,1.0,16,2.0,3.0,22.0,2.0,9.0,1,1,1.0,16,1.0,11.0,9.0,3.0,5.0,0,1,1.0,23,2.0,19.0,17.0,1.0,7.0,1,0,1.0,18,4.0,6.0,5.0,1.0,9.0,0,0,1.0,17,3.0,16.0,1.0,1.0,2.0,5.0,5.0,8.0,8.0,11.0,14.0,14.0,14.0,16.0,19.0,-3.0
29.0,2022,Everton Football Club,17.0,0.0,15.0,1,0,11.0,6,1.0,8.0,14.0,1.0,18.0,0,0,11.0,16,2.0,9.0,8.0,1.0,17.0,1,2,11.0,1,1.0,10.0,18.0,1.0,18.0,0,2,11.0,1,1.0,10.0,5.0,1.0,17.0,0,2,1.0,1,1.0,7.0,1.0,0.0,16.0,1,2,5.0,0,0.0,7.0,5.0,0.0,17.0,0,0,7.0,9,4.0,1.0,5.0,1.0,15.0,1,1,5.0,6,0.0,18.0,1.0,2.0,13.0,0,1,5.0,16,1.0,16.0,13.0,1.0,15.0,1,0,5.0,16,2.0,7.0,1.0,0.0,0.0,1.0,2.0,3.0,4.0,4.0,7.0,10.0,10.0,8.0,13.0,-5.0
985.0,2022,Manchester United Football Club,3.0,1.0,14.0,1,0,5.0,16,2.0,7.0,14.0,0.0,20.0,0,0,1.0,9,4.0,3.0,17.0,2.0,14.0,1,1,1.0,16,1.0,16.0,5.0,1.0,8.0,0,1,1.0,6,0.0,13.0,1.0,1.0,5.0,0,1,1.0,6,0.0,20.0,7.0,3.0,5.0,1,1,1.0,17,1.0,1.0,1.0,1.0,5.0,0,2,1.0,1,1.0,12.0,1.0,2.0,6.0,1,2,1.0,2,2.0,9.0,1.0,3.0,9.0,0,0,1.0,31,6.0,2.0,7.0,2.0,7.0,0,1,1.0,16,1.0,15.0,5.0,0.0,0.0,3.0,6.0,9.0,12.0,13.0,14.0,14.0,17.0,16.0,18.0,-2.0
1237.0,2022,Brighton and Hove Albion Football Club,6.0,2.0,7.0,0,1,14.0,16,1.0,14.0,5.0,0.0,8.0,1,2,14.0,0,0.0,5.0,5.0,2.0,5.0,0,1,14.0,7,0.0,20.0,1.0,1.0,4.0,1,1,1.0,6,0.0,5.0,1.0,1.0,4.0,0,0,7.0,16,2.0,8.0,1.0,5.0,4.0,1,1,14.0,25,2.0,20.0,13.0,2.0,3.0,0,1,1.0,7,0.0,15.0,12.0,1.0,3.0,1,1,1.0,6,0.0,14.0,5.0,3.0,3.0,0,2,14.0,3,3.0,5.0,5.0,0.0,4.0,1,0,14.0,6,1.0,3.0,9.0,3.0,4.0,7.0,10.0,10.0,13.0,16.0,19.0,20.0,20.0,17.0,9.0,8.0
543.0,2022,Wolverhampton Wanderers Football Club,13.0,1.0,13.0,0,0,5.0,16,2.0,6.0,1.0,0.0,14.0,1,2,1.0,0,0.0,13.0,1.0,0.0,18.0,0,0,1.0,6,1.0,4.0,22.0,1.0,19.0,1,2,5.0,1,1.0,7.0,5.0,0.0,18.0,0,2,7.0,0,0.0,16.0,1.0,1.0,14.0,1,1,5.0,6,0.0,12.0,5.0,0.0,16.0,0,0,1.0,7,2.0,6.0,5.0,0.0,17.0,1,0,5.0,8,3.0,2.0,5.0,0.0,18.0,0,0,14.0,7,2.0,17.0,1.0,0.0,18.0,0,0,1.0,8,3.0,6.0,1.0,0.0,1.0,1.0,2.0,3.0,6.0,6.0,6.0,6.0,6.0,3.0,14.0,-11.0
11.0,2022,Arsenal Football Club,2.0,2.0,2.0,0,1,1.0,7,0.0,19.0,1.0,4.0,2.0,1,1,1.0,24,2.0,15.0,9.0,3.0,1.0,0,1,1.0,8,0.0,15.0,9.0,2.0,1.0,1,1,1.0,16,1.0,11.0,1.0,2.0,1.0,1,1,1.0,16,1.0,19.0,5.0,1.0,1.0,0,0,1.0,17,3.0,5.0,1.0,4.0,1.0,1,1,5.0,9,0.0,17.0,7.0,3.0,1.0,0,1,1.0,8,0.0,8.0,9.0,3.0,1.0,1,1,5.0,17,1.0,4.0,22.0,3.0,1.0,1,1,1.0,23,2.0,8.0,1.0,3.0,6.0,9.0,12.0,15.0,15.0,18.0,21.0,24.0,27.0,27.0,10.0,17.0
631.0,2022,Chelsea Football Club,12.0,1.0,8.0,0,1,14.0,6,0.0,15.0,11.0,2.0,7.0,1,2,22.0,2,2.0,4.0,22.0,0.0,12.0,0,0,13.0,8,3.0,3.0,1.0,2.0,6.0,1,1,1.0,16,1.0,20.0,7.0,1.0,10.0,0,0,3.0,16,2.0,9.0,1.0,2.0,6.0,1,1,14.0,16,1.0,18.0,5.0,1.0,11.0,0,0,9.0,16,2.0,9.0,1.0,0.0,11.0,1,2,9.0,0,0.0,7.0,5.0,2.0,8.0,0,1,8.0,16,1.0,15.0,5.0,3.0,6.0,1,1,1.0,8,0.0,18.0,1.0,3.0,4.0,4.0,7.0,7.0,10.0,10.0,11.0,14.0,17.0,14.0,12.0,2.0
31.0,2022,Liverpool Football Club,5.0,2.0,10.0,0,2,5.0,2,2.0,9.0,1.0,1.0,12.0,1,2,5.0,1,1.0,16.0,11.0,1.0,16.0,0,0,5.0,16,2.0,14.0,1.0,9.0,9.0,1,1,5.0,14,0.0,17.0,1.0,2.0,6.0,1,1,5.0,16,1.0,12.0,5.0,0.0,7.0,0,2,5.0,0,0.0,16.0,5.0,2.0,6.0,1,1,5.0,7,0.0,16.0,1.0,0.0,7.0,0,2,5.0,0,0.0,11.0,9.0,3.0,5.0,1,2,5.0,3,3.0,3.0,14.0,2.0,8.0,0,0,1.0,23,3.0,1.0,1.0,1.0,2.0,2.0,5.0,8.0,9.0,12.0,13.0,14.0,14.0,22.0,12.0,10.0
281.0,2022,Manchester City Football Club,1.0,2.0,5.0,0,1,7.0,7,0.0,16.0,1.0,4.0,1.0,1,1,5.0,9,0.0,11.0,14.0,3.0,2.0,0,2,5.0,3,3.0,6.0,5.0,4.0,2.0,1,1,5.0,24,2.0,12.0,11.0,6.0,2.0,1,1,5.0,11,0.0,15.0,9.0,1.0,2.0,0,2,7.0,1,1.0,17.0,7.0,4.0,2.0,1,1,3.0,24,2.0,4.0,22.0,3.0,2.0,0,1,5.0,8,0.0,17.0,5.0,6.0,2.0,1,1,7.0,31,3.0,9.0,1.0,4.0,2.0,1,1,7.0,9,0.0,17.0,3.0,3.0,6.0,7.0,10.0,13.0,14.0,17.0,20.0,23.0,26.0,37.0,11.0,26.0
989.0,2022,Association Football Club Bournemouth,15.0,2.0,3.0,1,1,11.0,7,0.0,17.0,5.0,0.0,11.0,0,0,14.0,9,4.0,1.0,5.0,0.0,15.0,1,0,9.0,8,3.0,1.0,1.0,0.0,17.0,0,0,1.0,14,9.0,9.0,5.0,0.0,16.0,1,2,1.0,0,0.0,18.0,7.0,3.0,13.0,0,1,1.0,23,2.0,19.0,14.0,0.0,15.0,1,0,12.0,7,2.0,3.0,1.0,1.0,13.0,0,2,1.0,1,1.0,10.0,5.0,0.0,14.0,1,2,13.0,0,0.0,10.0,5.0,2.0,13.0,1,1,1.0,16,1.0,20.0,7.0,3.0,3.0,3.0,3.0,4.0,7.0,7.0,8.0,9.0,12.0,8.0,22.0,-14.0
762.0,2022,Newcastle United Football Club,4.0,2.0,4.0,1,1,5.0,7,0.0,18.0,17.0,0.0,5.0,0,2,5.0,0,0.0,8.0,14.0,3.0,6.0,1,2,5.0,3,3.0,2.0,5.0,1.0,7.0,0,2,5.0,1,1.0,19.0,5.0,1.0,12.0,0,0,5.0,16,2.0,6.0,5.0,0.0,11.0,1,2,5.0,0,0.0,15.0,5.0,5.0,10.0,0,1,5.0,19,1.0,18.0,1.0,1.0,10.0,1,2,5.0,1,1.0,13.0,1.0,4.0,6.0,0,1,5.0,18,1.0,7.0,1.0,5.0,5.0,1,1,5.0,19,1.0,10.0,9.0,3.0,4.0,5.0,6.0,6.0,7.0,10.0,11.0,14.0,17.0,22.0,10.0,12.0
148.0,2022,Tottenham Hotspur Football Club,8.0,4.0,1.0,1,1,22.0,18,1.0,20.0,25.0,2.0,4.0,0,2,22.0,2,2.0,7.0,22.0,1.0,4.0,1,1,22.0,6,0.0,18.0,1.0,2.0,3.0,0,1,22.0,7,0.0,14.0,14.0,1.0,3.0,0,2,22.0,1,1.0,14.0,1.0,2.0,3.0,1,1,22.0,16,1.0,10.0,1.0,2.0,4.0,0,0,22.0,24,4.0,2.0,3.0,6.0,4.0,1,1,22.0,26,2.0,20.0,7.0,1.0,4.0,0,0,22.0,17,3.0,1.0,5.0,1.0,3.0,0,1,9.0,6,0.0,4.0,14.0,3.0,4.0,7.0,10.0,11.0,14.0,14.0,17.0,17.0,20.0,22.0,14.0,8.0
1003.0,2022,Leicester City Football Club,18.0,2.0,11.0,1,2,9.0,2,2.0,12.0,5.0,2.0,15.0,0,0,9.0,24,4.0,2.0,1.0,1.0,19.0,1,0,7.0,16,2.0,11.0,1.0,1.0,20.0,0,0,7.0,16,2.0,6.0,1.0,0.0,20.0,1,0,7.0,6,1.0,5.0,1.0,2.0,20.0,0,0,13.0,25,5.0,4.0,14.0,1.0,20.0,1,0,5.0,16,2.0,13.0,13.0,2.0,20.0,0,0,7.0,26,6.0,4.0,22.0,4.0,19.0,1,1,7.0,9,0.0,20.0,1.0,1.0,20.0,0,0,7.0,16,2.0,13.0,1.0,1.0,1.0,1.0,1.0,1.0,1.0,1.0,1.0,4.0,4.0,16.0,26.0,-10.0
405.0,2022,Aston Villa Football Club,7.0,0.0,17.0,0,0,5.0,7,2.0,3.0,11.0,2.0,9.0,1,1,8.0,16,1.0,18.0,11.0,1.0,13.0,0,0,5.0,17,3.0,9.0,5.0,0.0,15.0,1,0,8.0,6,1.0,16.0,11.0,1.0,19.0,0,0,5.0,16,2.0,1.0,1.0,1.0,17.0,1,2,7.0,1,1.0,2.0,7.0,2.0,13.0,0,1,13.0,16,1.0,20.0,5.0,1.0,12.0,1,1,7.0,6,0.0,16.0,1.0,0.0,12.0,0,2,5.0,0,0.0,11.0,1.0,1.0,12.0,0,2,5.0,1,1.0,19.0,5.0,0.0,3.0,3.0,3.0,3.0,4.0,7.0,10.0,11.0,12.0,9.0,12.0,-3.0
399.0,2022,Leeds United,19.0,2.0,6.0,1,1,1.0,16,1.0,13.0,5.0,2.0,6.0,0,2,1.0,2,2.0,17.0,18.0,3.0,3.0,1,1,1.0,8,0.0,12.0,13.0,0.0,5.0,0,0,1.0,6,1.0,4.0,1.0,1.0,7.0,1,2,1.0,1,1.0,17.0,1.0,2.0,9.0,0,0,1.0,25,5.0,8.0,5.0,2.0,8.0,1,1,1.0,16,1.0,19.0,2.0,2.0,9.0,0,2,1.0,2,2.0,6.0,1.0,0.0,11.0,1,2,1.0,0,0.0,12.0,5.0,1.0,11.0,0,0,1.0,16,2.0,14.0,5.0,3.0,4.0,7.0,7.0,8.0,8.0,11.0,12.0,13.0,13.0,15.0,15.0,0.0
1148.0,2022,Brentford Football Club,9.0,2.0,12.0,0,2,5.0,2,2.0,11.0,9.0,4.0,3.0,1,1,17.0,9,0.0,20.0,1.0,2.0,8.0,0,0,5.0,23,3.0,7.0,1.0,1.0,10.0,1,2,5.0,1,1.0,18.0,11.0,1.0,11.0,0,2,5.0,1,1.0,13.0,7.0,5.0,8.0,1,1,5.0,25,2.0,9.0,1.0,2.0,7.0,0,1,5.0,7,0.0,14.0,1.0,0.0,8.0,1,0,9.0,8,3.0,1.0,1.0,0.0,10.0,0,2,5.0,0,0.0,14.0,13.0,1.0,10.0,0,0,9.0,19,5.0,5.0,5.0,1.0,4.0,4.0,5.0,6.0,9.0,12.0,12.0,13.0,13.0,18.0,17.0,1.0
180.0,2022,Southampton Football Club,20.0,1.0,20.0,0,0,25.0,18,4.0,1.0,22.0,2.0,17.0,1,2,18.0,2,2.0,6.0,1.0,2.0,11.0,0,1,1.0,16,1.0,19.0,7.0,0.0,13.0,1,0,1.0,6,1.0,8.0,1.0,2.0,9.0,1,1,1.0,16,1.0,10.0,3.0,0.0,12.0,0,0,5.0,6,1.0,14.0,5.0,0.0,14.0,1,0,1.0,7,2.0,7.0,5.0,0.0,16.0,0,0,1.0,6,1.0,12.0,7.0,1.0,16.0,1,0,13.0,16,2.0,13.0,5.0,0.0,17.0,0,0,3.0,9,4.0,2.0,7.0,0.0,1.0,4.0,4.0,7.0,7.0,7.0,7.0,7.0,7.0,8.0,19.0,-11.0
703.0,2022,Nottingham Forest Football Club,16.0,0.0,18.0,0,0,17.0,7,2.0,4.0,5.0,1.0,10.0,1,1,17.0,6,0.0,19.0,1.0,1.0,10.0,0,2,18.0,1,1.0,17.0,11.0,0.0,14.0,1,0,14.0,7,2.0,3.0,22.0,0.0,15.0,0,0,9.0,11,6.0,2.0,5.0,2.0,19.0,1,0,14.0,23,3.0,13.0,1.0,1.0,19.0,0,0,2.0,16,2.0,8.0,1.0,2.0,19.0,1,0,17.0,23,3.0,5.0,1.0,0.0,20.0,0,0,1.0,9,4.0,19.0,7.0,1.0,19.0,1,2,5.0,1,1.0,12.0,5.0,0.0,3.0,4.0,4.0,4.0,4.0,4.0,4.0,4.0,5.0,8.0,24.0,-16.0
379.0,2022,West Ham United Football Club,14.0,0.0,16.0,1,0,1.0,7,2.0,5.0,7.0,0.0,19.0,0,0,1.0,6,1.0,10.0,17.0,0.0,20.0,1,0,1.0,7,2.0,5.0,14.0,1.0,16.0,0,1,11.0,6,0.0,15.0,8.0,1.0,14.0,1,2,1.0,1,1.0,3.0,22.0,1.0,18.0,0,0,5.0,16,2.0,6.0,14.0,1.0,18.0,1,0,1.0,19,5.0,10.0,5.0,0.0,18.0,0,0,1.0,6,1.0,15.0,5.0,2.0,17.0,1,1,1.0,7,0.0,18.0,14.0,3.0,16.0,1,1,1.0,17,1.0,9.0,1.0,0.0,0.0,0.0,3.0,4.0,4.0,4.0,4.0,7.0,10.0,9.0,15.0,-6.0
873.0,2022,Crystal Palace Football Club,11.0,0.0,19.0,1,0,1.0,7,2.0,2.0,1.0,1.0,16.0,0,2,11.0,1,1.0,12.0,5.0,3.0,9.0,1,1,5.0,17,1.0,13.0,5.0,2.0,12.0,0,0,11.0,24,4.0,2.0,5.0,1.0,13.0,1,2,7.0,1,1.0,11.0,5.0,0.0,15.0,0,2,5.0,0,0.0,11.0,5.0,1.0,12.0,1,2,1.0,1,1.0,5.0,1.0,0.0,14.0,0,0,5.0,6,1.0,3.0,1.0,1.0,15.0,1,0,5.0,16,2.0,8.0,8.0,2.0,14.0,1,1,5.0,16,1.0,11.0,1.0,0.0,1.0,4.0,4.0,5.0,6.0,7.0,7.0,7.0,10.0,11.0,14.0,-3.0
350.0,2023,Sheffield United,20.0,0.0,14.0,1,0,22.0,6,1.0,5.0,1.0,1.0,16.0,0,0,14.0,16,2.0,19.0,22.0,1.0,17.0,1,0,9.0,16,2.0,1.0,1.0,2.0,18.0,1,2,9.0,2,2.0,20.0,12.0,1.0,18.0,0,0,9.0,16,2.0,2.0,1.0,0.0,19.0,1,0,14.0,13,8.0,8.0,5.0,0.0,19.0,0,0,9.0,7,2.0,7.0,1.0,1.0,19.0,0,0,9.0,17,3.0,12.0,5.0,1.0,19.0,1,0,3.0,16,2.0,8.0,1.0,0.0,20.0,0,0,3.0,10,5.0,2.0,5.0,0.0,0.0,0.0,1.0,1.0,1.0,1.0,1.0,1.0,1.0,7.0,29.0,-22.0
762.0,2023,Newcastle United Football Club,7.0,5.0,1.0,1,1,5.0,19,1.0,18.0,1.0,0.0,8.0,0,0,5.0,6,1.0,2.0,1.0,1.0,13.0,1,0,5.0,16,2.0,4.0,5.0,1.0,13.0,0,0,5.0,17,3.0,6.0,1.0,1.0,11.0,1,1,5.0,6,0.0,10.0,17.0,8.0,8.0,0,1,5.0,13,0.0,19.0,14.0,2.0,8.0,1,1,5.0,7,0.0,17.0,1.0,2.0,8.0,0,2,5.0,2,2.0,7.0,1.0,4.0,6.0,1,1,5.0,9,0.0,11.0,5.0,2.0,6.0,0,2,5.0,2,2.0,12.0,13.0,3.0,3.0,3.0,3.0,6.0,9.0,12.0,13.0,16.0,17.0,26.0,11.0,15.0
1237.0,2023,Brighton and Hove Albion Football Club,11.0,4.0,2.0,1,1,1.0,18,1.0,16.0,9.0,4.0,1.0,0,1,1.0,18,1.0,18.0,12.0,1.0,6.0,1,0,1.0,17,3.0,2.0,7.0,3.0,6.0,1,1,1.0,17,1.0,13.0,5.0,3.0,5.0,0,1,1.0,17,1.0,12.0,8.0,3.0,3.0,1,1,1.0,17,1.0,17.0,1.0,1.0,6.0,0,0,1.0,20,6.0,5.0,1.0,2.0,6.0,1,2,1.0,2,2.0,4.0,5.0,1.0,7.0,0,0,1.0,16,2.0,2.0,14.0,1.0,7.0,1,2,14.0,1,1.0,14.0,1.0,3.0,6.0,6.0,9.0,12.0,15.0,15.0,16.0,16.0,17.0,23.0,19.0,4.0
281.0,2023,Manchester City Football Club,1.0,3.0,3.0,0,1,1.0,8,0.0,17.0,11.0,1.0,2.0,1,1,1.0,6,0.0,8.0,5.0,2.0,1.0,0,1,1.0,16,1.0,17.0,9.0,5.0,1.0,1,1,1.0,19,1.0,12.0,5.0,3.0,1.0,0,1,1.0,17,1.0,6.0,1.0,2.0,1.0,1,1,1.0,7,0.0,16.0,11.0,1.0,1.0,0,0,1.0,16,2.0,14.0,22.0,0.0,3.0,0,0,5.0,6,1.0,2.0,5.0,2.0,2.0,1,1,14.0,16,1.0,7.0,1.0,3.0,3.0,0,1,1.0,8,0.0,8.0,1.0,3.0,6.0,9.0,12.0,15.0,18.0,18.0,18.0,21.0,24.0,22.0,7.0,15.0
405.0,2023,Aston Villa Football Club,4.0,1.0,18.0,0,0,1.0,19,5.0,1.0,5.0,4.0,9.0,1,1,1.0,9,0.0,20.0,7.0,3.0,7.0,0,1,14.0,17,1.0,15.0,13.0,0.0,9.0,0,0,14.0,8,3.0,3.0,5.0,3.0,7.0,1,1,1.0,17,1.0,8.0,12.0,1.0,6.0,0,1,1.0,6,0.0,13.0,1.0,6.0,5.0,1,1,1.0,20,1.0,6.0,1.0,1.0,5.0,0,2,13.0,1,1.0,13.0,22.0,4.0,5.0,1,1,3.0,18,1.0,9.0,1.0,3.0,5.0,1,1,3.0,17,1.0,17.0,17.0,0.0,3.0,6.0,6.0,9.0,12.0,15.0,16.0,19.0,22.0,26.0,14.0,12.0
985.0,2023,Manchester United Football Club,8.0,1.0,7.0,1,1,7.0,6,0.0,15.0,13.0,0.0,11.0,0,0,1.0,7,2.0,5.0,1.0,3.0,8.0,1,1,1.0,23,2.0,19.0,14.0,1.0,10.0,0,0,1.0,17,3.0,5.0,5.0,1.0,12.0,1,0,8.0,17,3.0,5.0,1.0,1.0,9.0,0,1,1.0,6,0.0,15.0,5.0,0.0,10.0,1,0,1.0,6,1.0,9.0,1.0,2.0,10.0,1,1,1.0,16,1.0,14.0,9.0,2.0,8.0,0,1,1.0,16,1.0,19.0,3.0,0.0,8.0,1,0,1.0,8,3.0,3.0,1.0,3.0,3.0,6.0,6.0,6.0,9.0,9.0,12.0,15.0,15.0,11.0,16.0,-5.0
873.0,2023,Crystal Palace Football Club,10.0,1.0,5.0,0,1,1.0,6,0.0,14.0,22.0,0.0,10.0,1,0,1.0,6,1.0,3.0,5.0,1.0,11.0,0,2,1.0,1,1.0,9.0,5.0,3.0,7.0,1,1,1.0,23,2.0,14.0,3.0,1.0,8.0,0,0,12.0,17,3.0,7.0,1.0,0.0,10.0,1,2,1.0,0,0.0,11.0,5.0,1.0,9.0,0,1,1.0,6,0.0,10.0,1.0,0.0,9.0,1,2,5.0,0,0.0,15.0,5.0,0.0,11.0,0,0,5.0,9,4.0,6.0,5.0,1.0,13.0,1,0,1.0,16,2.0,1.0,1.0,3.0,3.0,4.0,7.0,7.0,8.0,11.0,12.0,12.0,12.0,8.0,13.0,-5.0
703.0,2023,Nottingham Forest Football Club,17.0,1.0,19.0,0,0,14.0,16,2.0,4.0,5.0,2.0,19.0,1,1,22.0,16,1.0,16.0,14.0,2.0,19.0,0,0,14.0,23,3.0,8.0,1.0,1.0,16.0,0,1,14.0,6,0.0,11.0,14.0,1.0,15.0,1,2,1.0,1,1.0,14.0,1.0,0.0,16.0,0,0,11.0,7,2.0,1.0,1.0,1.0,15.0,1,2,5.0,1,1.0,13.0,5.0,0.0,15.0,0,2,5.0,0,0.0,9.0,5.0,2.0,15.0,1,2,5.0,2,2.0,16.0,13.0,0.0,15.0,0,0,11.0,8,3.0,4.0,5.0,0.0,3.0,3.0,6.0,7.0,7.0,8.0,9.0,10.0,10.0,10.0,15.0,-5.0
543.0,2023,Wolverhampton Wanderers Football Club,14.0,0.0,15.0,0,0,13.0,6,1.0,7.0,7.0,1.0,18.0,1,0,12.0,18,4.0,1.0,1.0,1.0,14.0,0,1,12.0,6,0.0,20.0,7.0,2.0,14.0,0,0,3.0,23,3.0,7.0,1.0,1.0,17.0,1,0,1.0,17,3.0,3.0,5.0,1.0,14.0,0,2,1.0,1,1.0,18.0,22.0,2.0,14.0,1,1,22.0,16,1.0,1.0,1.0,1.0,13.0,1,2,22.0,1,1.0,5.0,13.0,2.0,12.0,0,1,22.0,16,1.0,18.0,1.0,2.0,12.0,1,2,13.0,2,2.0,6.0,5.0,0.0,0.0,3.0,3.0,3.0,4.0,7.0,8.0,11.0,12.0,13.0,17.0,-4.0
1132.0,2023,Burnley FC,19.0,0.0,17.0,1,0,11.0,8,3.0,3.0,1.0,2.0,12.0,0,1,5.0,16,1.0,17.0,14.0,1.0,15.0,1,0,13.0,17,3.0,7.0,14.0,2.0,15.0,1,0,13.0,25,5.0,2.0,1.0,1.0,14.0,0,2,1.0,1,1.0,15.0,1.0,0.0,15.0,1,0,5.0,6,1.0,9.0,1.0,0.0,17.0,0,0,1.0,7,2.0,8.0,5.0,1.0,17.0,1,0,5.0,18,4.0,11.0,5.0,0.0,17.0,0,0,1.0,8,3.0,14.0,5.0,1.0,18.0,0,0,5.0,16,2.0,16.0,1.0,0.0,3.0,3.0,3.0,4.0,4.0,4.0,4.0,4.0,4.0,8.0,25.0,-17.0
31.0,2023,Liverpool Football Club,3.0,1.0,12.0,0,2,5.0,1,1.0,11.0,14.0,3.0,6.0,1,1,5.0,17,1.0,15.0,1.0,2.0,4.0,0,1,5.0,16,1.0,13.0,5.0,3.0,3.0,1,1,5.0,8,0.0,9.0,14.0,3.0,3.0,0,1,5.0,17,1.0,17.0,1.0,3.0,2.0,1,1,5.0,17,1.0,7.0,1.0,1.0,4.0,0,0,5.0,16,2.0,2.0,1.0,2.0,4.0,0,2,5.0,2,2.0,6.0,1.0,2.0,4.0,1,1,5.0,7,0.0,20.0,12.0,3.0,4.0,1,1,5.0,8,0.0,15.0,11.0,1.0,4.0,7.0,10.0,13.0,16.0,16.0,17.0,20.0,23.0,23.0,9.0,14.0
631.0,2023,Chelsea Football Club,6.0,1.0,11.0,1,2,14.0,1,1.0,12.0,5.0,1.0,14.0,0,0,14.0,17,3.0,7.0,1.0,3.0,10.0,1,1,14.0,8,0.0,18.0,17.0,0.0,11.0,1,0,14.0,6,1.0,16.0,14.0,0.0,13.0,0,2,1.0,0,0.0,16.0,1.0,0.0,13.0,1,0,1.0,6,1.0,6.0,1.0,2.0,11.0,0,1,5.0,7,0.0,12.0,5.0,4.0,11.0,0,1,5.0,18,1.0,17.0,5.0,2.0,10.0,1,2,1.0,2,2.0,3.0,5.0,0.0,11.0,1,0,1.0,7,2.0,10.0,9.0,1.0,1.0,4.0,4.0,5.0,5.0,8.0,11.0,12.0,12.0,13.0,11.0,2.0
148.0,2023,Tottenham Hotspur Football Club,5.0,2.0,8.0,0,2,1.0,2,2.0,9.0,17.0,2.0,5.0,1,1,1.0,7,0.0,11.0,1.0,2.0,3.0,0,1,1.0,7,0.0,16.0,1.0,5.0,2.0,0,1,1.0,25,2.0,15.0,13.0,2.0,2.0,1,1,1.0,16,1.0,18.0,9.0,2.0,4.0,0,2,1.0,2,2.0,5.0,5.0,2.0,2.0,1,1,1.0,16,1.0,4.0,5.0,1.0,1.0,0,1,1.0,6,0.0,16.0,3.0,2.0,1.0,1,1,1.0,7,0.0,13.0,1.0,2.0,1.0,0,1,1.0,16,1.0,13.0,1.0,1.0,4.0,7.0,10.0,13.0,14.0,17.0,20.0,23.0,26.0,22.0,9.0,13.0
379.0,2023,West Ham United Football Club,9.0,1.0,10.0,0,2,1.0,1,1.0,13.0,1.0,3.0,7.0,1,1,1.0,17,1.0,14.0,14.0,3.0,2.0,0,1,7.0,17,1.0,6.0,1.0,2.0,4.0,0,1,1.0,16,1.0,19.0,17.0,1.0,6.0,1,0,1.0,17,3.0,1.0,1.0,1.0,7.0,0,0,1.0,17,3.0,2.0,5.0,2.0,7.0,1,1,1.0,7,0.0,19.0,9.0,2.0,7.0,1,2,1.0,2,2.0,8.0,5.0,1.0,9.0,0,0,1.0,18,4.0,5.0,3.0,0.0,9.0,1,0,1.0,6,1.0,19.0,12.0,1.0,4.0,7.0,10.0,10.0,10.0,13.0,14.0,14.0,14.0,16.0,17.0,-1.0
1031.0,2023,Luton Town,18.0,1.0,16.0,0,0,9.0,18,4.0,2.0,1.0,1.0,17.0,1,0,14.0,16,2.0,12.0,5.0,0.0,18.0,0,0,17.0,8,3.0,10.0,14.0,1.0,19.0,1,0,17.0,16,2.0,4.0,1.0,0.0,19.0,0,0,17.0,6,1.0,9.0,5.0,1.0,18.0,1,2,22.0,1,1.0,14.0,1.0,2.0,16.0,0,1,14.0,16,1.0,20.0,12.0,0.0,16.0,1,0,3.0,6,1.0,1.0,1.0,2.0,16.0,0,2,13.0,2,2.0,15.0,5.0,1.0,17.0,0,0,17.0,17,3.0,5.0,3.0,0.0,0.0,0.0,0.0,0.0,1.0,4.0,4.0,5.0,5.0,9.0,20.0,-11.0
989.0,2023,Association Football Club Bournemouth,12.0,1.0,13.0,1,2,1.0,1,1.0,10.0,1.0,1.0,15.0,0,0,1.0,17,3.0,6.0,5.0,0.0,16.0,1,0,1.0,7,2.0,3.0,1.0,2.0,17.0,0,2,1.0,2,2.0,8.0,5.0,0.0,16.0,1,2,1.0,0,0.0,13.0,1.0,1.0,17.0,0,0,1.0,17,3.0,3.0,1.0,0.0,18.0,1,0,1.0,9,4.0,3.0,5.0,0.0,18.0,0,0,1.0,8,3.0,20.0,12.0,1.0,18.0,1,0,1.0,16,2.0,12.0,22.0,2.0,16.0,1,1,1.0,16,1.0,18.0,5.0,1.0,1.0,1.0,2.0,3.0,3.0,3.0,3.0,3.0,6.0,8.0,21.0,-13.0
29.0,2023,Everton Football Club,15.0,0.0,20.0,1,0,12.0,6,1.0,6.0,5.0,0.0,20.0,0,0,7.0,9,4.0,9.0,1.0,0.0,20.0,1,0,7.0,6,1.0,14.0,12.0,2.0,20.0,0,2,12.0,2,2.0,18.0,9.0,0.0,20.0,1,0,6.0,6,1.0,4.0,5.0,3.0,20.0,0,1,12.0,17,1.0,12.0,5.0,1.0,20.0,1,0,12.0,16,2.0,16.0,14.0,3.0,20.0,1,1,12.0,8,0.0,18.0,1.0,0.0,20.0,0,0,12.0,7,2.0,4.0,5.0,1.0,19.0,0,1,12.0,6,0.0,9.0,1.0,0.0,0.0,0.0,1.0,1.0,4.0,4.0,7.0,7.0,10.0,10.0,14.0,-4.0
931.0,2023,Fulham Football Club,13.0,1.0,6.0,0,1,5.0,6,0.0,20.0,12.0,0.0,13.0,1,0,5.0,8,3.0,4.0,5.0,2.0,12.0,0,2,5.0,2,2.0,5.0,5.0,1.0,12.0,0,0,5.0,19,5.0,1.0,1.0,1.0,9.0,1,1,5.0,6,0.0,19.0,17.0,0.0,11.0,0,2,5.0,0,0.0,10.0,1.0,0.0,12.0,1,0,5.0,7,2.0,11.0,5.0,3.0,12.0,1,1,5.0,17,1.0,19.0,9.0,0.0,13.0,0,0,1.0,7,2.0,1.0,1.0,1.0,14.0,0,2,1.0,1,1.0,7.0,14.0,3.0,3.0,4.0,4.0,7.0,8.0,8.0,11.0,11.0,12.0,9.0,16.0,-7.0
11.0,2023,Arsenal Football Club,2.0,2.0,4.0,1,1,5.0,16,1.0,19.0,14.0,1.0,3.0,0,1,5.0,6,0.0,10.0,1.0,2.0,5.0,1,2,5.0,2,2.0,12.0,5.0,3.0,5.0,1,1,5.0,17,1.0,10.0,1.0,1.0,4.0,0,1,5.0,6,0.0,20.0,6.0,2.0,5.0,1,2,5.0,2,2.0,4.0,1.0,4.0,3.0,0,1,5.0,9,0.0,18.0,1.0,1.0,2.0,1,1,5.0,6,0.0,3.0,5.0,2.0,3.0,0,2,5.0,2,2.0,10.0,1.0,5.0,2.0,1,1,5.0,10,0.0,20.0,3.0,3.0,6.0,7.0,10.0,13.0,14.0,17.0,20.0,21.0,24.0,23.0,8.0,15.0
1148.0,2023,Brentford Football Club,16.0,2.0,9.0,1,2,17.0,2,2.0,8.0,1.0,3.0,4.0,0,1,5.0,8,0.0,13.0,5.0,1.0,9.0,1,2,5.0,1,1.0,11.0,1.0,2.0,8.0,1,2,5.0,2,2.0,17.0,1.0,0.0,10.0,0,0,17.0,6,1.0,11.0,5.0,1.0,12.0,1,0,5.0,17,3.0,20.0,12.0,1.0,13.0,0,2,5.0,1,1.0,15.0,5.0,1.0,14.0,0,0,9.0,16,2.0,10.0,1.0,3.0,14.0,1,1,5.0,8,0.0,17.0,1.0,2.0,10.0,0,1,9.0,7,0.0,11.0,1.0,1.0,4.0,5.0,6.0,6.0,6.0,7.0,7.0,10.0,13.0,16.0,12.0,4.0
11.0,2024,Arsenal Football Club,2.0,2.0,2.0,1,1,5.0,7,0.0,19.0,1.0,2.0,3.0,0,1,5.0,7,0.0,12.0,13.0,1.0,4.0,1,2,5.0,1,1.0,3.0,1.0,1.0,2.0,0,1,3.0,6,0.0,13.0,5.0,2.0,4.0,0,2,3.0,2,2.0,1.0,5.0,4.0,3.0,1,1,3.0,24,2.0,17.0,1.0,3.0,3.0,1,1,13.0,17,1.0,19.0,11.0,0.0,3.0,0,0,1.0,7,2.0,11.0,1.0,2.0,3.0,1,2,13.0,2,2.0,2.0,1.0,0.0,5.0,0,0,13.0,6,1.0,11.0,5.0,3.0,6.0,7.0,10.0,11.0,14.0,17.0,17.0,18.0,18.0,17.0,11.0,6.0
1148.0,2024,Brentford Football Club,10.0,2.0,6.0,1,1,5.0,16,1.0,13.0,14.0,0.0,13.0,0,0,5.0,7,2.0,4.0,5.0,3.0,6.0,1,1,5.0,17,1.0,19.0,9.0,1.0,9.0,0,0,9.0,16,2.0,1.0,1.0,1.0,12.0,0,0,17.0,17,3.0,10.0,5.0,1.0,12.0,1,2,10.0,1,1.0,14.0,7.0,5.0,11.0,1,1,1.0,30,3.0,20.0,7.0,1.0,13.0,0,0,1.0,16,2.0,12.0,1.0,4.0,9.0,1,1,1.0,29,3.0,18.0,1.0,1.0,12.0,0,0,1.0,16,2.0,9.0,1.0,3.0,3.0,6.0,6.0,6.0,7.0,10.0,10.0,13.0,13.0,19.0,20.0,-1.0
1237.0,2024,Brighton and Hove Albion Football Club,8.0,3.0,1.0,0,1,1.0,8,0.0,20.0,1.0,2.0,2.0,1,1,1.0,16,1.0,11.0,1.0,1.0,3.0,0,2,1.0,1,1.0,4.0,5.0,0.0,6.0,1,2,3.0,0,0.0,17.0,1.0,2.0,7.0,1,2,1.0,2,2.0,8.0,1.0,2.0,9.0,0,0,5.0,24,4.0,4.0,1.0,3.0,6.0,1,1,1.0,23,2.0,9.0,5.0,1.0,5.0,0,1,13.0,6,0.0,9.0,5.0,2.0,6.0,1,2,13.0,2,2.0,19.0,14.0,1.0,8.0,0,0,13.0,16,2.0,1.0,1.0,3.0,6.0,7.0,8.0,9.0,9.0,12.0,15.0,16.0,16.0,17.0,14.0,3.0
931.0,2024,Fulham Football Club,11.0,0.0,15.0,0,0,1.0,6,1.0,7.0,1.0,2.0,10.0,1,1,1.0,16,1.0,15.0,1.0,1.0,12.0,0,2,5.0,1,1.0,17.0,1.0,1.0,12.0,1,2,1.0,1,1.0,14.0,1.0,3.0,9.0,1,1,1.0,17,1.0,6.0,5.0,1.0,6.0,0,1,1.0,6,0.0,10.0,13.0,2.0,8.0,0,0,22.0,23,3.0,2.0,7.0,1.0,10.0,1,0,1.0,17,3.0,4.0,1.0,1.0,10.0,0,2,1.0,1,1.0,16.0,1.0,2.0,9.0,1,1,1.0,16,1.0,12.0,1.0,0.0,3.0,4.0,5.0,8.0,11.0,11.0,11.0,12.0,15.0,14.0,13.0,1.0
281.0,2024,Manchester City Football Club,3.0,2.0,4.0,0,1,14.0,7,0.0,17.0,1.0,4.0,1.0,1,1,14.0,18,1.0,18.0,1.0,3.0,1.0,0,1,14.0,17,1.0,13.0,1.0,2.0,1.0,1,1,1.0,16,1.0,9.0,9.0,2.0,1.0,1,2,5.0,2,2.0,4.0,3.0,1.0,2.0,0,2,1.0,1,1.0,7.0,5.0,3.0,2.0,1,1,7.0,23,2.0,8.0,22.0,2.0,2.0,0,1,7.0,16,1.0,20.0,9.0,1.0,1.0,1,1,7.0,6,0.0,20.0,11.0,1.0,2.0,0,0,7.0,16,2.0,10.0,1.0,3.0,6.0,9.0,12.0,13.0,14.0,17.0,20.0,23.0,23.0,21.0,11.0,10.0
543.0,2024,Wolverhampton Wanderers Football Club,16.0,0.0,19.0,0,0,1.0,7,2.0,2.0,5.0,2.0,19.0,1,0,1.0,26,6.0,8.0,1.0,1.0,18.0,0,2,12.0,1,1.0,9.0,1.0,1.0,18.0,1,0,12.0,16,2.0,3.0,5.0,1.0,20.0,0,0,7.0,17,3.0,3.0,1.0,1.0,20.0,1,0,7.0,16,2.0,1.0,1.0,3.0,20.0,0,0,7.0,30,5.0,11.0,1.0,1.0,20.0,1,0,9.0,16,2.0,2.0,7.0,2.0,19.0,0,2,14.0,2,2.0,6.0,13.0,2.0,20.0,1,2,14.0,2,2.0,17.0,14.0,0.0,0.0,1.0,1.0,1.0,1.0,1.0,1.0,2.0,3.0,14.0,27.0,-13.0
703.0,2024,Nottingham Forest Football Club,7.0,1.0,11.0,1,2,1.0,1,1.0,9.0,1.0,1.0,7.0,0,1,1.0,6,0.0,16.0,9.0,1.0,9.0,1,2,1.0,1,1.0,18.0,12.0,1.0,7.0,0,1,1.0,6,0.0,4.0,1.0,2.0,8.0,0,2,1.0,2,2.0,7.0,1.0,0.0,10.0,1,0,13.0,6,1.0,6.0,1.0,1.0,10.0,0,2,1.0,1,1.0,4.0,1.0,1.0,8.0,1,1,1.0,6,0.0,18.0,14.0,3.0,7.0,0,1,1.0,17,1.0,15.0,1.0,3.0,3.0,1,1,1.0,8,0.0,14.0,14.0,1.0,4.0,5.0,8.0,9.0,9.0,10.0,13.0,16.0,19.0,14.0,7.0,7.0
1003.0,2024,Leicester City Football Club,18.0,1.0,10.0,1,2,1.0,1,1.0,12.0,5.0,1.0,15.0,0,0,1.0,16,2.0,10.0,1.0,1.0,15.0,1,0,1.0,16,2.0,7.0,3.0,2.0,15.0,0,2,1.0,2,2.0,16.0,22.0,1.0,15.0,1,2,1.0,1,1.0,19.0,1.0,2.0,17.0,0,0,1.0,24,4.0,3.0,3.0,1.0,15.0,1,1,1.0,6,0.0,13.0,1.0,3.0,14.0,0,1,1.0,23,2.0,19.0,6.0,1.0,15.0,1,0,1.0,17,3.0,7.0,1.0,1.0,15.0,0,2,1.0,1,1.0,18.0,1.0,1.0,1.0,1.0,2.0,3.0,3.0,6.0,9.0,9.0,10.0,14.0,18.0,-4.0
677.0,2024,Ipswich Town Football Club,19.0,0.0,18.0,1,0,1.0,7,2.0,3.0,5.0,1.0,18.0,0,0,1.0,18,4.0,1.0,14.0,1.0,17.0,1,2,1.0,1,1.0,12.0,5.0,0.0,17.0,0,2,1.0,0,0.0,6.0,3.0,1.0,17.0,0,2,1.0,1,1.0,18.0,1.0,2.0,15.0,1,2,1.0,2,2.0,5.0,1.0,1.0,17.0,0,0,1.0,18,4.0,12.0,7.0,0.0,17.0,1,0,1.0,7,2.0,16.0,1.0,3.0,18.0,0,0,1.0,29,4.0,9.0,1.0,1.0,18.0,1,2,1.0,1,1.0,15.0,1.0,0.0,0.0,1.0,2.0,3.0,4.0,4.0,4.0,4.0,5.0,10.0,21.0,-11.0
148.0,2024,Tottenham Hotspur Football Club,17.0,1.0,12.0,0,2,5.0,1,1.0,10.0,1.0,4.0,5.0,1,1,5.0,9,0.0,20.0,1.0,1.0,10.0,0,0,5.0,16,2.0,5.0,5.0,0.0,13.0,1,0,5.0,6,1.0,2.0,3.0,3.0,10.0,1,1,5.0,17,1.0,12.0,17.0,3.0,8.0,0,1,5.0,8,0.0,13.0,1.0,2.0,9.0,0,0,5.0,23,3.0,6.0,1.0,4.0,7.0,1,1,5.0,18,1.0,15.0,7.0,0.0,8.0,0,0,5.0,6,1.0,17.0,14.0,4.0,7.0,1,1,5.0,18,1.0,6.0,1.0,1.0,4.0,4.0,4.0,7.0,10.0,10.0,13.0,13.0,16.0,22.0,11.0,11.0
873.0,2024,Crystal Palace Football Club,12.0,1.0,13.0,0,0,14.0,16,2.0,6.0,5.0,0.0,17.0,1,0,14.0,7,2.0,9.0,7.0,1.0,16.0,0,2,14.0,1,1.0,11.0,1.0,2.0,16.0,1,2,22.0,2,2.0,15.0,1.0,0.0,16.0,1,2,14.0,0,0.0,11.0,1.0,1.0,18.0,0,0,22.0,16,2.0,16.0,1.0,0.0,18.0,1,0,22.0,6,1.0,1.0,1.0,0.0,18.0,0,0,14.0,6,1.0,8.0,1.0,1.0,17.0,1,1,14.0,6,0.0,8.0,5.0,2.0,17.0,0,2,14.0,2,2.0,20.0,14.0,0.0,0.0,1.0,2.0,3.0,3.0,3.0,3.0,6.0,7.0,8.0,13.0,-5.0
31.0,2024,Liverpool Football Club,1.0,2.0,3.0,0,1,5.0,7,0.0,18.0,1.0,2.0,4.0,1,1,5.0,7,0.0,13.0,5.0,3.0,2.0,0,1,1.0,8,0.0,14.0,1.0,0.0,4.0,1,0,1.0,6,1.0,7.0,1.0,3.0,2.0,1,1,1.0,8,0.0,13.0,1.0,2.0,1.0,0,1,1.0,16,1.0,20.0,7.0,1.0,1.0,0,1,1.0,6,0.0,18.0,22.0,2.0,1.0,1,1,1.0,16,1.0,6.0,1.0,2.0,2.0,0,2,1.0,2,2.0,3.0,13.0,2.0,1.0,1,1,1.0,16,1.0,8.0,13.0,3.0,6.0,9.0,9.0,12.0,15.0,18.0,21.0,22.0,25.0,19.0,6.0,13.0
762.0,2024,Newcastle United Football Club,5.0,1.0,8.0,1,1,5.0,6,0.0,16.0,9.0,1.0,6.0,0,2,5.0,1,1.0,14.0,1.0,2.0,5.0,1,1,5.0,16,1.0,10.0,5.0,2.0,3.0,0,1,5.0,16,1.0,18.0,12.0,1.0,6.0,0,0,5.0,17,3.0,9.0,1.0,1.0,7.0,1,2,5.0,1,1.0,2.0,1.0,0.0,7.0,0,2,5.0,0,0.0,16.0,1.0,0.0,9.0,1,0,5.0,6,1.0,5.0,13.0,1.0,12.0,0,0,5.0,16,2.0,5.0,1.0,1.0,11.0,1,1,5.0,6,0.0,5.0,13.0,3.0,4.0,7.0,10.0,10.0,11.0,12.0,12.0,12.0,15.0,10.0,10.0,0.0
379.0,2024,West Ham United Football Club,14.0,1.0,14.0,1,0,7.0,16,2.0,5.0,1.0,2.0,9.0,0,1,7.0,7,0.0,17.0,14.0,1.0,13.0,1,0,1.0,17,3.0,1.0,14.0,1.0,14.0,0,2,1.0,1,1.0,12.0,1.0,0.0,14.0,1,0,22.0,8,3.0,5.0,1.0,1.0,14.0,0,2,7.0,1,1.0,12.0,10.0,4.0,12.0,1,1,7.0,18,1.0,17.0,1.0,1.0,15.0,0,0,7.0,18,4.0,7.0,5.0,2.0,13.0,1,1,1.0,16,1.0,14.0,1.0,0.0,14.0,0,0,14.0,8,3.0,3.0,1.0,0.0,3.0,3.0,4.0,4.0,5.0,8.0,8.0,11.0,11.0,13.0,19.0,-6.0
989.0,2024,Association Football Club Bournemouth,9.0,1.0,9.0,0,2,1.0,1,1.0,11.0,1.0,1.0,14.0,1,2,1.0,1,1.0,6.0,5.0,3.0,8.0,0,1,1.0,23,2.0,20.0,1.0,0.0,11.0,1,0,1.0,6,1.0,8.0,1.0,0.0,13.0,0,0,1.0,8,3.0,2.0,1.0,3.0,11.0,1,1,1.0,17,1.0,19.0,1.0,0.0,13.0,0,0,1.0,6,1.0,15.0,1.0,2.0,11.0,1,1,1.0,7,0.0,3.0,1.0,1.0,11.0,0,2,1.0,1,1.0,4.0,12.0,2.0,10.0,1,1,1.0,16,1.0,2.0,7.0,1.0,2.0,5.0,5.0,5.0,8.0,8.0,11.0,12.0,15.0,13.0,12.0,1.0
631.0,2024,Chelsea Football Club,4.0,0.0,17.0,1,0,1.0,7,2.0,4.0,14.0,6.0,8.0,0,1,1.0,26,2.0,19.0,1.0,1.0,11.0,1,2,1.0,1,1.0,16.0,14.0,1.0,8.0,0,1,1.0,6,0.0,11.0,1.0,3.0,5.0,0,1,1.0,8,0.0,14.0,22.0,4.0,4.0,1,1,1.0,24,2.0,9.0,5.0,1.0,4.0,1,2,1.0,1,1.0,10.0,1.0,1.0,6.0,0,0,1.0,16,2.0,1.0,1.0,2.0,5.0,1,1,1.0,16,1.0,12.0,5.0,1.0,4.0,0,2,1.0,1,1.0,13.0,1.0,0.0,3.0,4.0,7.0,10.0,13.0,14.0,14.0,17.0,18.0,20.0,12.0,8.0
405.0,2024,Aston Villa Football Club,6.0,2.0,5.0,0,1,1.0,16,1.0,14.0,7.0,0.0,12.0,1,0,13.0,7,2.0,3.0,5.0,2.0,7.0,0,1,3.0,16,1.0,15.0,1.0,3.0,5.0,1,1,1.0,23,2.0,20.0,1.0,3.0,3.0,1,1,1.0,17,1.0,20.0,7.0,2.0,5.0,0,2,1.0,2,2.0,15.0,1.0,0.0,5.0,1,2,1.0,0,0.0,14.0,1.0,3.0,4.0,0,1,1.0,17,1.0,10.0,1.0,1.0,4.0,1,2,12.0,1,1.0,11.0,1.0,1.0,6.0,0,0,1.0,18,4.0,7.0,5.0,3.0,3.0,6.0,9.0,12.0,13.0,14.0,17.0,18.0,18.0,17.0,15.0,2.0
180.0,2024,Southampton Football Club,20.0,0.0,16.0,0,0,9.0,6,1.0,8.0,5.0,0.0,16.0,1,0,9.0,6,1.0,7.0,1.0,1.0,19.0,0,0,9.0,17,3.0,6.0,5.0,0.0,19.0,1,0,1.0,8,3.0,10.0,1.0,1.0,18.0,1,2,1.0,1,1.0,17.0,1.0,1.0,19.0,0,0,1.0,17,3.0,11.0,1.0,1.0,19.0,0,0,11.0,17,3.0,3.0,13.0,2.0,19.0,1,0,6.0,23,3.0,14.0,1.0,0.0,20.0,0,0,11.0,6,1.0,1.0,7.0,1.0,19.0,1,1,11.0,6,0.0,16.0,1.0,0.0,0.0,0.0,0.0,1.0,1.0,1.0,1.0,1.0,4.0,7.0,19.0,-12.0
985.0,2024,Manchester United Football Club,15.0,1.0,7.0,1,1,1.0,6,0.0,15.0,1.0,1.0,11.0,0,0,1.0,16,2.0,2.0,1.0,0.0,14.0,1,0,1.0,8,3.0,2.0,1.0,3.0,10.0,0,1,1.0,8,0.0,19.0,1.0,0.0,11.0,0,2,1.0,0,0.0,16.0,14.0,0.0,13.0,1,0,1.0,8,3.0,8.0,5.0,0.0,14.0,0,2,1.0,0,0.0,5.0,1.0,2.0,12.0,1,1,1.0,16,1.0,13.0,1.0,1.0,14.0,0,0,1.0,16,2.0,13.0,1.0,1.0,13.0,1,2,1.0,1,1.0,4.0,1.0,3.0,3.0,3.0,6.0,7.0,7.0,8.0,11.0,11.0,12.0,9.0,12.0,-3.0
29.0,2024,Everton Football Club,13.0,0.0,20.0,1,0,1.0,8,3.0,1.0,1.0,0.0,20.0,0,0,1.0,9,4.0,5.0,5.0,2.0,20.0,1,0,1.0,23,3.0,8.0,1.0,2.0,20.0,0,0,1.0,23,3.0,5.0,1.0,1.0,19.0,0,2,1.0,1,1.0,15.0,1.0,2.0,16.0,1,1,1.0,16,1.0,18.0,22.0,0.0,16.0,1,2,1.0,0,0.0,7.0,5.0,2.0,16.0,0,1,1.0,7,0.0,17.0,1.0,1.0,16.0,1,2,1.0,1,1.0,10.0,1.0,0.0,16.0,0,0,1.0,6,1.0,19.0,11.0,0.0,0.0,0.0,0.0,1.0,4.0,5.0,8.0,9.0,9.0,10.0,17.0,-7.0
